Account ,Date,Transaction Type,No.,Name,Memo/Description,Split,Amount,Balance
Apple Account,,,,,,,,
,4/1/2022,Transaction,,Online Sale,,Receivables,3.15,3.15
,4/1/2022,Transaction,,Online Sale,,Receivables,6.22,9.37
,5/1/2022,Transaction,,Online Sale,,Receivables,5.51,14.88
,6/1/2022,Transaction,,Online Sale,,Receivables,3.83,18.71
,6/1/2022,Transaction,,Online Sale,,Receivables,2.98,21.69
,7/1/2022,Transaction,,Online Sale,,Receivables,5.41,27.1
,7/1/2022,Transaction,,Online Sale,,Receivables,3.29,30.39
,11/1/2022,Transaction,,Online Sale,,Receivables,3.54,33.93
,11/1/2022,Transaction,,Online Sale,,Receivables,1.35,35.28
Total for Apple Account,,,,,,,£0.00  ,
Cash Reserve,,,,,,,,
,26/04/2022,Reimbursement,1890,John Doe,,Orders in Hand/Deferred Income,"-4,697.50","-4,697.50"
,26/04/2022,Transaction,,John Doe,,Receivables,"4,697.50",0
Total for Cash Reserve,,,,,,,£0.00  ,
Business Card,,,,,,,,
,15/01/2022,Fund Transfer,,,,EastX Bank,"3,241.02","3,241.02"
,31/01/2022,Bank Draft,764,,,MARKETING/SELLING:Postage and Delivery,-34.33,"3,206.69"
,31/01/2022,Bank Draft,763,,,-Split-,-176.45,"3,030.24"
,31/01/2022,Bank Draft,769,,,-Split-,-96.09,"2,934.15"
,31/01/2022,Bank Draft,768,,,-Split-,-113.13,"2,821.02"
,31/01/2022,Bank Draft,770,,,MARKETING/SELLING:Subsistasnce and Entertainment expenses,-205,"2,616.02"
,31/01/2022,Bank Draft,767,,,-Split-,-311.19,"2,304.83"
,31/01/2022,Bank Draft,766,,,-Split-,-557.7,"1,747.13"
,31/01/2022,Expense Transaction (Bank Draft),762,Heritage pvt Ltd,,Payables,"-1,509.60",237.53
,31/01/2022,Bank Draft,765,,,-Split-,-237.53,0
,11/2/2022,Fund Transfer,,,,EastX Bank,"4,273.16","4,273.16"
Total for Business Card,,,,,,,£0.00  ,
EastX Bank,,,,,,,,
,Beginning Balance,,,,,,,"102,365.42"
,2/12/2022,Transaction,,Northwood Group Norway AS,,Receivables,858,"6,353.74"
,2/12/2022,Transaction,,The Traditional English cases Ltd,,Receivables,743.22,"7,096.96"
,6/12/2022,Transaction,,David Austin,,Receivables,"26,685.00","33,781.96"
,7/12/2022,Fund Transfer,,,,EastX  Saver ****7829,"-150,000.00","-116,218.04"
,7/12/2022,Transaction,,Outdoor Outfitters,,Receivables,"364,173.80","247,955.76"
,8/12/2022,Expense Transaction (Bank Draft),9370,Northwood Group UK Vendor,,Payables,"-18,242.40","229,713.36"
,8/12/2022,Expense Transaction (Bank Draft),9368,Northwood Group,,Payables,"-116,779.30","112,934.06"
,10/12/2022,Transaction,,David Modesett,,Receivables,"147,820.00","260,754.06"
,10/12/2022,Transaction,,Sheikh Salman Bin Ebrahim Al-Khalifa,,Receivables,"15,987.75","276,741.81"
,12/12/2022,Ledger Entry,3394,,Refund of overTransaction being received from Lothar,-Split-,"1,117.81","277,859.62"
,12/12/2022,Ledger Entry,3394,,Refund of overTransaction being received from Lothar,-Split-,"3,341.13","281,200.75"
,12/12/2022,Bank Draft,,Abacus GP Ltd,,MARKETING/SELLING:Car Rental,-203.41,"280,997.34"
,12/12/2022,Fund Transfer,,,,EastX  Saver ****7829,"-70,000.00","210,997.34"
,13/12/2022,Fund Transfer,,,,Business Card,"-9,909.44","201,087.90"
,13/12/2022,Expense Transaction (Bank Draft),9366,Abacus GP Ltd,,Payables,"-1,326.87","199,761.03"
,13/12/2022,Expense Transaction (Bank Draft),9364,Northwood GMBH,,Payables,"-9,373.00","190,388.03"
,14/12/2022,Expense Transaction (Bank Draft),9365,Northwood Group SAS,,Payables,"-17,900.00","172,488.03"
,14/12/2022,Transaction,,Armurerie Mallet,,Receivables,"1,272.00","173,760.03"
,15/12/2022,Expense Transaction (Bank Draft),9367,Abacus GP Ltd,,Payables,"-1,045.12","172,714.91"
,16/12/2022,Expense Transaction (Bank Draft),9376,Royal,,Payables,"-6,120.86","166,594.05"
,16/12/2022,Bank Draft,9374,Abacus GP Ltd,,MARKETING/SELLING:Car Rental,-348.37,"166,245.68"
,17/12/2022,Transaction,,James Walton,,Receivables,"5,162.40","171,408.08"
,17/12/2022,Transaction,,HH Sheikh Mohammed Al-Sharqi,,Receivables,"186,000.00","357,408.08"
,17/12/2022,Expense Transaction (Bank Draft),9372,Abacus GP Ltd,,Payables,-568,"356,840.08"
,17/12/2022,Transaction,,Steven F Clark,,Receivables,"6,940.00","363,780.08"
,20/12/2022,Transaction,,Armurerie Richard,,Receivables,"30,754.00","394,534.08"
,20/12/2022,Transaction,,Tommy Salmon,,Receivables,"13,385.89","407,919.97"
,20/12/2022,Fund Transfer,,,,EastX  Saver ****7829,"-50,000.00","357,919.97"
,21/12/2022,Bank Draft,9375,Elite communication,,MARKETING/SELLING:Telephone Expense,-549.83,"357,370.14"
,22/12/2022,Fund Transfer,,,,EastX  Saver ****7829,"-40,000.00","317,370.14"
,24/12/2022,Transaction,,Pablo Gonzalez,,Receivables,88.8,"317,458.94"
,24/12/2022,Expense Transaction (Bank Draft),9377,TMC Ltd,,Payables,"-57,742.80","259,716.14"
,31/12/2022,Transaction,,Krister Karki,,Receivables,850,"260,566.14"
,31/12/2022,Bank Draft,9378,Castle Water,,ADMINISTRATION:Utilities,-24.32,"260,541.82"
,31/12/2022,Ledger Entry,3400,,EastX bank Account package fee,-Split-,"-2,025.00","258,516.82"
,31/12/2022,Fund Transfer,,,,EastX  Saver ****7829,"-30,000.00","228,516.82"
,31/12/2022,Transaction,,Giancarlo Lugli,,Receivables,"11,614.00","240,130.82"
Total for EastX Bank,,,,,,,"£137,765.40  ",
EastX 2233,,,,,,,,
,Beginning Balance,,,,,,,1.62
Total for EastX 2233,,,,,,,,
EastX ****2310,,,,,,,,
,Beginning Balance,,,,,,,"4,999.81"
,2/1/2022,Transaction,,Online Sale,,Receivables,134.88,"5,134.69"
,2/1/2022,Transaction,,Online Sale,,Receivables,570.69,"5,705.38"
,2/1/2022,Transaction,,Online Sale,,Receivables,320.25,"6,025.63"
,2/1/2022,Transaction,,Online Sale,,Receivables,349.83,"6,375.46"
,2/1/2022,Transaction,,Online Sale,,Receivables,320.25,"6,695.71"
,2/1/2022,Transaction,,Online Sale,,Receivables,142.77,"6,838.48"
,31/12/2022,Expense Transaction (Bank Draft),Mary2186,guntrader.co.uk,,Payables,-63.6,"1,534.70"
,31/12/2022,Bank Draft,Mary2187,Aerial Direct,,MARKETING/SELLING:Telephone Expense,-158.35,"1,376.35"
,31/12/2022,Expense Transaction (Bank Draft),Mary2181,Ray St Ledger & Sons,,Payables,-90,"1,286.35"
,31/12/2022,Expense Transaction (Bank Draft),Mary2168,Aform Tooling Limited,,Payables,"-3,336.00","-2,049.65"
,31/12/2022,Expense Transaction (Bank Draft),Mary2180,SRS Freight Ltd,,Payables,"-11,076.75","-13,126.40"
,31/12/2022,Expense Transaction (Bank Draft),Mary2185,Tweed Media,,Payables,"-6,360.00","-19,486.40"
,31/12/2022,Expense Transaction (Bank Draft),Mary2173,TimberLake Workshop,,Payables,-322.9,"-19,809.30"
,31/12/2022,Expense Transaction (Bank Draft),Mary2169,Broadbent Leather goods,,Payables,-202.5,"-20,011.80"
,31/12/2022,Fund Transfer,,,,EastX  Saver ****7829,"12,000.00","-8,011.80"
,31/12/2022,Fund Transfer,,,,EastX  Saver ****7829,"20,000.00","11,988.20"
,31/12/2022,Fund Transfer,,,,EastX  Saver ****7829,"15,000.00","26,988.20"
,31/12/2022,Expense Transaction (Bank Draft),Mary2179,Mayfair  Engineering,,Payables,"-3,606.00","23,382.20"
,31/12/2022,Expense Transaction (Bank Draft),Mary2183,Swieton Brice,,Payables,-43.69,"23,338.51"
,31/12/2022,Expense Transaction (Bank Draft),Mary2176,John Whitfield,,Payables,-450,"22,888.51"
,31/12/2022,Expense Transaction (Bank Draft),Mary2182,Revolution Wines,,Payables,-30,"22,858.51"
,31/12/2022,Expense Transaction (Bank Draft),Mary2178,London Barrel Maker,,Payables,"-6,480.00","16,378.51"
,31/12/2022,Expense Transaction (Bank Draft),Mary2172,Edgar Brothers,,Payables,-81.91,"16,296.60"
,31/12/2022,Expense Transaction (Bank Draft),Mary2170,CJB Engineering,,Payables,"-1,500.00","14,796.60"
,31/12/2022,Expense Transaction (Bank Draft),Mary2175,GWT Media,,Payables,-28.8,"14,767.80"
,31/12/2022,Expense Transaction (Bank Draft),Mary2190,Worldpay,,Payables,-145.47,"14,622.33"
,31/12/2022,Expense Transaction (Bank Draft),Mary2189,Wireless Terminal Solutions,,Payables,-529.6,"14,092.73"
,31/12/2022,Ledger Entry,3398,,EastX  current account charge,-Split-,-43.77,"14,048.96"
,31/12/2022,Ledger Entry,3411,,Web sale refund,-Split-,-82.5,"13,966.46"
,31/12/2022,Expense Transaction (Bank Draft),Mary2184,The Company of Gunmakers,,Payables,"-1,231.32","12,735.14"
,31/12/2022,Expense Transaction (Bank Draft),Mary2174,GMK,,Payables,-432.72,"12,302.42"
,31/12/2022,Expense Transaction (Bank Draft),Mary2177,L W Butler,,Payables,"-1,134.00","11,168.42"
,31/12/2022,Expense Transaction (Bank Draft),Mary2167,A.S.I Ltd,,Payables,-154.8,"11,013.62"
,31/12/2022,Expense Transaction (Bank Draft),Mary2171,Coggan Simon Engraver,,Payables,-40,"10,973.62"
Total for EastX ****2310,,,,,,,"£5,973.81  ",
EastX  Saver ****7829,,,,,,,,
,Beginning Balance,,,,,,,"23,631.31"
,1/1/2022,Transaction,,SHOP SALE,,Receivables,50,"23,681.31"
,4/1/2022,Fund Transfer,,,,EastX Bank,"30,000.00","53,681.31"
,4/1/2022,Fund Transfer,,,,EastX ****2310,"-10,000.00","43,681.31"
,5/1/2022,Fund Transfer,,,,EastX ****2310,"-30,000.00","13,681.31"
,6/1/2022,Fund Transfer,,,,EastX Bank,"20,000.00","33,681.31"
,12/12/2022,Fund Transfer,,,,EastX Bank,"70,000.00","120,166.97"
,13/12/2022,Fund Transfer,,,,EastX ****2310,"-20,000.00","100,166.97"
,14/12/2022,Fund Transfer,,,,EastX ****2310,"-30,000.00","70,166.97"
,16/12/2022,Transaction,,SHOP SALE,,Receivables,185,"70,351.97"
,16/12/2022,Transaction,,John Reed,,Receivables,"2,244.00","72,595.97"
,17/12/2022,Transaction,,SHOP SALE,,Receivables,162,"72,757.97"
,20/12/2022,Fund Transfer,,,,EastX ****2310,"-20,000.00","52,757.97"
,20/12/2022,Transaction,,Victor  Galea,,Receivables,210,"52,967.97"
,20/12/2022,Fund Transfer,,,,EastX ****2310,"-100,000.00","-47,032.03"
,20/12/2022,Fund Transfer,,,,EastX Bank,"50,000.00","2,967.97"
,21/12/2022,Transaction,,Geoffrey Lignon,,Receivables,104,"3,071.97"
,21/12/2022,Fund Transfer,,,,EastX ****2310,"-2,000.00","1,071.97"
,21/12/2022,Transaction,,Sheikh Mustufa Bin Abdullah,,Receivables,288,"1,359.97"
,22/12/2022,Fund Transfer,,,,EastX Bank,"40,000.00","41,359.97"
,22/12/2022,Transaction,,SHOP SALE,,Receivables,69,"41,428.97"
,22/12/2022,Fund Transfer,,,,EastX ****2310,"-20,000.00","21,428.97"
,27/12/2022,Transaction,,Bertrand  Batoux,,Receivables,79.2,"21,508.17"
,31/12/2022,Ledger Entry,3399,,interest income,-Split-,0.35,"21,508.52"
,31/12/2022,Fund Transfer,,,,EastX ****2310,"-20,000.00","1,508.52"
,31/12/2022,Fund Transfer,,,,EastX Bank,"30,000.00","31,508.52"
,31/12/2022,Fund Transfer,,,,EastX ****2310,"-15,000.00","16,508.52"
,31/12/2022,Fund Transfer,,,,EastX ****2310,"-12,000.00","4,508.52"
Total for EastX  Saver ****7829,,,,,,,"-£19,122.79  ",
Miscellenous Cash,,,,,,,,
,Beginning Balance,,,,,,,324.38
Total for Miscellenous Cash,,,,,,,,
Receivables,,,,,,,,
,Beginning Balance,,,,,,,"1,055,215.10"
,1/1/2022,Transaction,,SHOP SALE,,EastX  Saver ****7829,-50,"1,055,165.10"
,2/1/2022,Transaction,,Online Sale,,EastX ****2310,-142.77,"1,055,022.33"
,2/1/2022,Transaction,,Online Sale,,EastX ****2310,-320.25,"1,054,702.08"
,2/1/2022,Transaction,,Online Sale,,EastX ****2310,-410.64,"1,054,291.44"
,2/1/2022,Transaction,,Online Sale,,EastX ****2310,-570.69,"1,053,720.75"
,2/1/2022,Transaction,,Online Sale,,EastX ****2310,-134.88,"1,053,585.87"
,2/1/2022,Transaction,,Online Sale,,EastX ****2310,-349.83,"1,053,236.04"
,2/1/2022,Transaction,,Online Sale,,EastX ****2310,-78.29,"1,053,157.75"
,2/1/2022,Transaction,,Online Sale,,EastX ****2310,-320.25,"1,052,837.50"
,4/1/2022,Receipt,12064,Online Sale,,Sales of Product Income:UK Sales,211,"1,053,048.50"
,4/1/2022,Transaction,,Online Sale,,EastX ****2310,-207.85,"1,052,840.65"
,4/1/2022,Transaction,,Online Sale,,Apple Account,-3.15,"1,052,837.50"
,4/1/2022,Transaction,,Online Sale,,Apple Account,-6.22,"1,052,831.28"
,4/1/2022,Transaction,,Online Sale,,EastX ****2310,-352.11,"1,052,479.17"
,4/1/2022,Receipt,12067,David Austin,,Sales of Product Income:Non UK Sales,9,"1,052,488.17"
,4/1/2022,Receipt,12066,Gut Grambow SonySports GmbH,,-Split-,385,"1,052,873.17"
,4/1/2022,Receipt,12068,Online Sale,,Sales of Product Income:Non UK Sales,358.33,"1,053,231.50"
,5/1/2022,Transaction,,Online Sale,,Apple Account,-5.51,"1,053,225.99"
,5/1/2022,Transaction,,Online Sale,,EastX ****2310,-373.66,"1,052,852.33"
,5/1/2022,Receipt,12069,Online Sale,,Sales of Product Income:Non UK Sales,379.17,"1,053,231.50"
,5/1/2022,Receipt,12070,Northwood USA 1,,-Split-,620,"1,053,851.50"
,6/1/2022,Receipt,12072,Online Sale,,Sales of Product Income:Non UK Sales,125,"1,053,976.50"
,6/1/2022,Transaction,,Online Sale,,EastX ****2310,-121.17,"1,053,855.33"
,6/1/2022,Transaction,,Online Sale,,Apple Account,-3.83,"1,053,851.50"
,6/1/2022,Transaction,,Online Sale,,EastX ****2310,-93.02,"1,053,758.48"
,6/1/2022,Receipt,12071,Online Sale,,Sales of Product Income:UK Sales,96,"1,053,854.48"
,6/1/2022,Receipt,12073,Armurerie Nouvelle,,-Split-,"136,500.00","1,190,354.48"
,6/1/2022,Transaction,,Online Sale,,Apple Account,-2.98,"1,190,351.50"
,6/1/2022,Transaction,,JAFI,,EastX Bank,-700,"1,189,651.50"
,7/1/2022,Transaction,,SHOP SALE,,EastX  Saver ****7829,-219,"1,189,432.50"
,7/1/2022,Transaction,,Online Sale,,Apple Account,-5.41,"1,189,427.09"
,7/1/2022,Transaction,,Online Sale,,EastX ****2310,-366.59,"1,189,060.50"
,7/1/2022,Transaction,,Online Sale,,EastX ****2310,-103.38,"1,188,957.12"
,7/1/2022,Transaction,,Online Sale,,Apple Account,-3.29,"1,188,953.83"
,7/1/2022,Receipt,12076,SHOP SALE,,Sales of Product Income:Non UK Sales,0,"1,188,953.83"
,7/1/2022,Receipt,12077,SHOP SALE,,-Split-,219,"1,189,172.83"
,7/1/2022,Receipt,12075,Online Sale,,Sales of Product Income:Non UK Sales,106.67,"1,189,279.50"
,7/1/2022,Receipt,12074,Online Sale,,Sales of Product Income:UK Sales,372,"1,189,651.50"
,8/1/2022,Receipt,12078,Francesco Lenzerini,,Orders in Hand/Deferred Income,900,"1,190,551.50"
,9/1/2022,Transaction,,Marco Schmid,,EastX Bank,"-1,304.00","1,189,247.50"
,9/1/2022,Transaction,,Armurerie Nouvelle,,EastX Bank,"-145,356.00","1,043,891.50"
,11/1/2022,Transaction,,Online Sale,,EastX ****2310,-231.87,"1,043,659.63"
,11/1/2022,Transaction,,Online Sale,,Apple Account,-7.13,"1,043,652.50"
,11/1/2022,Transaction,,Online Sale,,EastX ****2310,-80.65,"1,043,571.85"
,11/1/2022,Transaction,,Online Sale,,Apple Account,-1.75,"1,043,570.10"
,11/1/2022,Transaction,,Online Sale,,Apple Account,-0.97,"1,043,569.13"
,11/1/2022,Transaction,,Online Sale,,EastX ****2310,-111.46,"1,043,457.67"
,11/1/2022,Receipt,12079,Online Sale,,Sales of Product Income:Non UK Sales,239,"1,043,696.67"
,11/1/2022,Receipt,12082,Online Sale,,Sales of Product Income:Non UK Sales,55,"1,043,751.67"
,11/1/2022,Receipt,12083,Online Sale,,Sales of Product Income:UK Sales,82,"1,043,833.67"
,11/1/2022,Receipt,12081,Online Sale,,Sales of Product Income:UK Sales,111,"1,043,944.67"
,11/1/2022,Receipt,12080,Online Sale,,Sales of Product Income:Non UK Sales,115,"1,044,059.67"
,11/1/2022,Transaction,,Online Sale,,EastX ****2310,-109.25,"1,043,950.42"
,11/1/2022,Transaction,,Online Sale,,Apple Account,-3.54,"1,043,946.88"
,11/1/2022,Transaction,,Online Sale,,Apple Account,-1.35,"1,043,945.53"
,11/1/2022,Transaction,,Online Sale,,EastX ****2310,-54.03,"1,043,891.50"
,12/1/2022,Transaction,,Online Sale,,EastX ****2310,-103.38,"1,043,788.12"
,12/1/2022,Transaction,,Online Sale,,Apple Account,-3.29,"1,043,784.83"
,12/1/2022,Transaction,,Online Sale,,EastX ****2310,-155.16,"1,043,629.67"
,12/1/2022,Transaction,,Online Sale,,Apple Account,-4.84,"1,043,624.83"
,12/1/2022,Transaction,,JAFI,,EastX Bank,"-6,055.00","1,037,569.83"
,12/1/2022,Transaction,,Steven F Clark,,EastX Bank,"-5,080.00","1,032,489.83"
,12/1/2022,Receipt,12087,Ifzaal  Musa,,Sales of Product Income:Non UK Sales,"1,350.00","1,033,839.83"
,12/1/2022,Receipt,12086,David Austin,,Sales of Product Income:Non UK Sales,24,"1,033,863.83"
,12/1/2022,Receipt,12085,Online Sale,,Sales of Product Income:Non UK Sales,106.67,"1,033,970.50"
,12/1/2022,Receipt,12084,Online Sale,,Sales of Product Income:Non UK Sales,160,"1,034,130.50"
,13/01/2022,Transaction,,Online Sale,,EastX ****2310,-51.07,"1,034,079.43"
,13/01/2022,Transaction,,Online Sale,,Apple Account,-3.18,"1,034,076.25"
,13/01/2022,Transaction,,Online Sale,,EastX ****2310,-291.49,"1,033,784.76"
,13/01/2022,Transaction,,Online Sale,,Apple Account,-4.34,"1,033,780.42"
,13/01/2022,Receipt,12090,Online Sale,,Sales of Product Income:UK Sales,52,"1,033,832.42"
,13/01/2022,Transaction,,Online Sale,,EastX ****2310,-209.32,"1,033,623.10"
,13/01/2022,Receipt,12092,Northwood USA 1,,-Split-,"1,453.90","1,035,077.00"
,13/01/2022,Receipt,12089,Online Sale,,Sales of Product Income:Non UK Sales,212.5,"1,035,289.50"
,13/01/2022,Receipt,12091,Online Sale,,Sales of Product Income:Non UK Sales,295.83,"1,035,585.33"
,13/01/2022,Transaction,,Online Sale,,Apple Account,-0.93,"1,035,584.40"
,14/01/2022,Receipt,12094,L&O Group SA,,-Split-,943.12,"1,036,527.52"
,14/01/2022,Receipt,11972,L&O Group SA,,-Split-,"104,504.65","1,141,032.17"
,15/01/2022,Receipt,12095,Online Sale,,Sales of Product Income:Non UK Sales,166.67,"1,141,198.84"
,15/01/2022,Transaction,,Vance Daigle,,EastX Bank,"-15,075.00","1,126,123.84"
,15/01/2022,Receipt,12096,Chris Dianda,,Sales of Product Income:Non UK Sales,250,"1,126,373.84"
,15/01/2022,Transaction,,Online Sale,,EastX ****2310,-161.64,"1,126,212.20"
,15/01/2022,Transaction,,Online Sale,,Apple Account,-5.03,"1,126,207.17"
,18/01/2022,Receipt,12102,HH Sheikh Mohammed Al-Sharqi,,Sales of Product Income:Non UK Sales,"1,950.00","1,128,157.17"
,18/01/2022,Transaction,,Online Sale,,EastX ****2310,-79.1,"1,128,078.07"
,18/01/2022,Receipt,12099,Online Sale,,Sales of Product Income:Non UK Sales,560.83,"1,128,638.90"
,18/01/2022,Receipt,12098,Online Sale,,Sales of Product Income:Non UK Sales,81.67,"1,128,720.57"
,18/01/2022,Receipt,12097,Online Sale,,Sales of Product Income:Non UK Sales,198.33,"1,128,918.90"
,18/01/2022,Transaction,,Online Sale,,EastX ****2310,-192.38,"1,128,726.52"
,18/01/2022,Transaction,,Online Sale,,Apple Account,-5.95,"1,128,720.57"
,18/01/2022,Debit Memo,CN8532,Sheikh Salman Bin Ebrahim Al-Khalifa,,-Split-,"-17,730.17","1,110,990.40"
,18/01/2022,Transaction,,Sheikh Salman Bin Ebrahim Al-Khalifa,,-Split-,,"1,110,990.40"
,18/01/2022,Transaction,,Sheikh Salman Bin Ebrahim Al-Khalifa,,-Split-,,"1,110,990.40"
,18/01/2022,Transaction,,Sheikh Salman Bin Ebrahim Al-Khalifa,,-Split-,,"1,110,990.40"
,18/01/2022,Transaction,,Online Sale,,Apple Account,-8.05,"1,110,982.35"
,18/01/2022,Transaction,,Online Sale,,Apple Account,-2.57,"1,110,979.78"
,18/01/2022,Transaction,,Online Sale,,EastX ****2310,-552.78,"1,110,427.00"
,18/01/2022,Receipt,12101,Sheikh Salman Bin Ebrahim Al-Khalifa,,Sales of Product Income:Non UK Sales,"2,267.00","1,112,694.00"
,19/01/2022,Receipt,12104,Online Sale,,-Split-,41,"1,112,735.00"
,19/01/2022,Receipt,12103,Online Sale,,Sales of Product Income:Non UK Sales,628.33,"1,113,363.33"
,19/01/2022,Transaction,,Sheikh Khalid Bin Ibrahim Al-Khalifa,,EastX Bank,"-7,173.43","1,106,189.90"
,19/01/2022,Transaction,,Online Sale,,EastX ****2310,-40.23,"1,106,149.67"
,19/01/2022,Transaction,,Online Sale,,Apple Account,-18.42,"1,106,131.25"
,19/01/2022,Transaction,,Online Sale,,EastX ****2310,-609.91,"1,105,521.34"
,19/01/2022,Transaction,,Online Sale,,Apple Account,-0.77,"1,105,520.57"
,20/01/2022,Transaction,,Paul F Barnhart Jr,,EastX Bank,"-63,022.50","1,042,498.07"
,21/01/2022,Receipt,12106,Online Sale,,Sales of Product Income:Non UK Sales,681.67,"1,043,179.74"
,21/01/2022,Transaction,,Online Sale,,Apple Account,-11.8,"1,043,167.94"
,21/01/2022,Receipt,12107,Armurerie Nouvelle,,Sales of Product Income:Non UK Sales,900,"1,044,067.94"
,21/01/2022,Receipt,12105,Online Sale,,Sales of Product Income:UK Sales,197,"1,044,264.94"
,21/01/2022,Receipt,12110,Online Sale,,Sales of Product Income:Non UK Sales,157.5,"1,044,422.44"
,21/01/2022,Receipt,12109,Online Sale,,Sales of Product Income:Non UK Sales,400,"1,044,822.44"
,21/01/2022,Transaction,,Online Sale,,Apple Account,-19.97,"1,044,802.47"
,21/01/2022,Transaction,,Online Sale,,EastX ****2310,-661.7,"1,044,140.77"
,21/01/2022,Transaction,,Online Sale,,EastX ****2310,-194.04,"1,043,946.73"
,21/01/2022,Transaction,,Online Sale,,Apple Account,-2.96,"1,043,943.77"
,21/01/2022,Transaction,,Mauritz Widforss AB,,EastX Bank,"-1,300.00","1,042,643.77"
,21/01/2022,Transaction,,Online Sale,,Apple Account,-2.41,"1,042,641.36"
,21/01/2022,Transaction,,Online Sale,,EastX ****2310,-155.09,"1,042,486.27"
,21/01/2022,Transaction,,Online Sale,,EastX ****2310,-388.2,"1,042,098.07"
,21/01/2022,Receipt,12108,L&O Group SA,,Sales of Product Income:Non UK Sales,"4,017.00","1,046,115.07"
,22/01/2022,Receipt,12113,Online Sale,,Sales of Product Income:Non UK Sales,310,"1,046,425.07"
,22/01/2022,Receipt,12111,Online Sale,,Sales of Product Income:Non UK Sales,111.67,"1,046,536.74"
,22/01/2022,Receipt,12112,Online Sale,,Sales of Product Income:Non UK Sales,790,"1,047,326.74"
,22/01/2022,Transaction,,Online Sale,,EastX ****2310,-300.81,"1,047,025.93"
,22/01/2022,Transaction,,Online Sale,,Apple Account,-9.19,"1,047,016.74"
,22/01/2022,Transaction,,Lupus,,EastX Bank,"-5,000.00","1,042,016.74"
,22/01/2022,Transaction,,Online Sale,,EastX ****2310,-766.89,"1,041,249.85"
,22/01/2022,Transaction,,Online Sale,,EastX ****2310,-108.23,"1,041,141.62"
,22/01/2022,Transaction,,Online Sale,,Apple Account,-3.44,"1,041,138.18"
,22/01/2022,Transaction,,Ifzaal  Musa,,EastX Bank,"-9,000.00","1,032,138.18"
,22/01/2022,Transaction,,Online Sale,,Apple Account,-23.11,"1,032,115.07"
,25/01/2022,Receipt,12117,HH Sheikh Mohammed Al-Sharqi,,Sales of Product Income:Non UK Sales,"4,000.00","1,036,115.07"
,25/01/2022,Receipt,12118,Thomas Hill,,Sales of Product Income:Non UK Sales,0,"1,036,115.07"
,25/01/2022,Receipt,12116,David Austin,,Sales of Product Income:Non UK Sales,"2,000.00","1,038,115.07"
,25/01/2022,Receipt,12115,Online Sale,,Sales of Product Income:Non UK Sales,110.83,"1,038,225.90"
,25/01/2022,Transaction,,Online Sale,,EastX ****2310,-236.89,"1,037,989.01"
,25/01/2022,Transaction,,Online Sale,,Apple Account,-7.28,"1,037,981.73"
,25/01/2022,Transaction,,Online Sale,,Apple Account,-3.41,"1,037,978.32"
,25/01/2022,Transaction,,Online Sale,,EastX ****2310,-107.42,"1,037,870.90"
,25/01/2022,Receipt,12114,Online Sale,,Sales of Product Income:Non UK Sales,244.17,"1,038,115.07"
,26/01/2022,Transaction,,HH Sheikh Mohammed Al-Sharqi,,Apple Account,-12,"1,038,103.07"
,26/01/2022,Transaction,,HH Sheikh Mohammed Al-Sharqi,,EastX Bank,"-99,988.00","938,115.07"
,29/01/2022,Receipt,12120,Online Sale,,Sales of Product Income:Non UK Sales,207.5,"938,322.57"
,29/01/2022,Receipt,12128,Sheikh Salman Bin Ebrahim Al-Khalifa,,Sales of Product Income:Non UK Sales,"6,041.00","944,363.57"
,29/01/2022,Transaction,,Stephen Anderson,,-Split-,,"944,363.57"
,29/01/2022,Debit Memo,12123,Stephen Anderson,,Sales of Product Income:Non UK Sales,-900,"943,463.57"
,29/01/2022,Transaction,,Online Sale,,Apple Account,-3.11,"943,460.46"
,29/01/2022,Receipt,12122,Sheikh Khalid Bin Ibrahim Al-Khalifa,,-Split-,"11,786.20","955,246.66"
,29/01/2022,Receipt,12121,Online Sale,,Sales of Product Income:Non UK Sales,45.83,"955,292.49"
,29/01/2022,Transaction,,Online Sale,,Apple Account,-0.84,"955,291.65"
,30/01/2022,Transaction,,Vance Daigle,,EastX Bank,"-26,437.02","928,854.63"
,1/2/2022,Receipt,12125,Online Sale,,Sales of Product Income:Non UK Sales,83.33,"928,937.96"
,1/2/2022,Receipt,12127,SHOP SALE,,Sales of Product Income:UK Sales,200,"929,137.96"
,1/2/2022,Receipt,12126,Online Sale,,Sales of Product Income:UK Sales,257,"929,394.96"
,1/2/2022,Receipt,12124,Online Sale,,Sales of Product Income:UK Sales,102,"929,496.96"
,1/2/2022,Transaction,,Online Sale,,Apple Account,-1.37,"929,495.59"
,1/2/2022,Transaction,,Sheikh Salman Bin Ebrahim Al-Khalifa,,-Split-,,"929,495.59"
,1/2/2022,Transaction,,Online Sale,,Apple Account,-3.8,"929,491.79"
,1/2/2022,Transaction,,Online Sale,,EastX ****2310,-81.96,"929,409.83"
,1/2/2022,Transaction,,Online Sale,,EastX ****2310,-100.37,"929,309.46"
,1/2/2022,Transaction,,Online Sale,,Apple Account,-1.63,"929,307.83"
,1/2/2022,Transaction,,SHOP SALE,,EastX  Saver ****7829,-200,"929,107.83"
,1/2/2022,Transaction,,Online Sale,,EastX ****2310,-253.2,"928,854.63"
,2/2/2022,Receipt,12129,Online Sale,,Sales of Product Income:UK Sales,292,"929,146.63"
,2/2/2022,Transaction,,Online Sale,,EastX ****2310,-44.99,"929,101.64"
,2/2/2022,Transaction,,Online Sale,,EastX ****2310,-287.71,"928,813.93"
,2/2/2022,Transaction,,Online Sale,,Apple Account,-4.29,"928,809.64"
,2/2/2022,Transaction,,Online Sale,,EastX ****2310,-204.39,"928,605.25"
,3/2/2022,Receipt,12130,HH Sheikh Mohammed Al-Sharqi,,Sales of Product Income:Non UK Sales,800,"929,405.25"
,4/2/2022,Receipt,12131,Vance Daigle,,Orders in Hand/Deferred Income,"25,000.00","954,405.25"
,4/2/2022,Transaction,,Vance Daigle,,Apple Account,-52.98,"954,352.27"
,4/2/2022,Transaction,,L&O Group SA,,EastX Bank,"-105,447.77","848,904.50"
,5/2/2022,Receipt,12132,Online Sale,,Sales of Product Income:Non UK Sales,54,"848,958.50"
,5/2/2022,Receipt,12135,Online Sale,,Sales of Product Income:UK Sales,24,"848,982.50"
,5/2/2022,Receipt,12133,Online Sale,,Sales of Product Income:Non UK Sales,173.33,"849,155.83"
,5/2/2022,Transaction,,Online Sale,,Apple Account,-0.54,"849,155.29"
,5/2/2022,Transaction,,Online Sale,,EastX ****2310,-170.7,"848,984.59"
,5/2/2022,Transaction,,Online Sale,,EastX ****2310,-53.04,"848,931.55"
,5/2/2022,Transaction,,Sheikh Khalid Bin Abdullah,,EastX  Saver ****7829,-172.83,"848,758.72"
,5/2/2022,Transaction,,Online Sale,,Apple Account,-2.63,"848,756.09"
,5/2/2022,Transaction,,Online Sale,,EastX ****2310,-23.46,"848,732.63"
,5/2/2022,Transaction,,Online Sale,,Apple Account,-0.96,"848,731.67"
,8/2/2022,Receipt,12138,Online Sale,,Sales of Product Income:Non UK Sales,185,"848,916.67"
,8/2/2022,Receipt,12134,Gut Grambow SonySports GmbH,,-Split-,"1,765.83","850,682.50"
,8/2/2022,Receipt,12139,Online Sale,,Sales of Product Income:Non UK Sales,239,"850,921.50"
,8/2/2022,Receipt,12137,Online Sale,,Sales of Product Income:Non UK Sales,218.33,"851,139.83"
,8/2/2022,Receipt,12136,Online Sale,,Sales of Product Income:Non UK Sales,233.33,"851,373.16"
,8/2/2022,Receipt,12140,Vere Harmsworth,,Sales of Product Income:Sales,408,"851,781.16"
,8/2/2022,Transaction,,Online Sale,,Apple Account,-3.47,"851,777.69"
,8/2/2022,Transaction,,Online Sale,,EastX ****2310,-231.87,"851,545.82"
,8/2/2022,Transaction,,Online Sale,,EastX ****2310,-215.07,"851,330.75"
,8/2/2022,Transaction,,Online Sale,,Apple Account,-7.13,"851,323.62"
,8/2/2022,Transaction,,Online Sale,,EastX ****2310,-179.43,"851,144.19"
,8/2/2022,Transaction,,Online Sale,,Apple Account,-3.26,"851,140.93"
,8/2/2022,Transaction,,Online Sale,,EastX ****2310,-229.86,"850,911.07"
,8/2/2022,Transaction,,Online Sale,,Apple Account,-5.57,"850,905.50"
,9/2/2022,Receipt,12141,Online Sale,,Sales of Product Income:Non UK Sales,229.17,"851,134.67"
,9/2/2022,Transaction,,Sheikh Khalid Bin Ibrahim Al-Khalifa,,EastX Bank,"-7,173.43","843,961.24"
,9/2/2022,Transaction,,Online Sale,,Apple Account,-3.41,"843,957.83"
,9/2/2022,Transaction,,Online Sale,,EastX ****2310,-225.76,"843,732.07"
,11/2/2022,Receipt,12145,SHOP SALE,,Sales of Product Income:UK Sales,0,"843,732.07"
,11/2/2022,Receipt,12143,Online Sale,,Sales of Product Income:Non UK Sales,137.5,"843,869.57"
,11/2/2022,Receipt,12144,Online Sale,,Sales of Product Income:Non UK Sales,341.67,"844,211.24"
,11/2/2022,Receipt,12142,Online Sale,,Sales of Product Income:Non UK Sales,106.67,"844,317.91"
,11/2/2022,Debit Memo,12146,SHOP SALE,,Sales of Product Income:UK Sales,-10,"844,307.91"
,11/2/2022,Transaction,,Online Sale,,Apple Account,-2.13,"844,305.78"
,11/2/2022,Transaction,,Online Sale,,EastX ****2310,-336.69,"843,969.09"
,11/2/2022,Transaction,,Online Sale,,Apple Account,-3.29,"843,965.80"
,11/2/2022,Transaction,,Online Sale,,EastX ****2310,-103.38,"843,862.42"
,11/2/2022,Transaction,,Online Sale,,EastX ****2310,-135.37,"843,727.05"
,11/2/2022,Transaction,,Online Sale,,Apple Account,-4.98,"843,722.07"
,11/2/2022,Transaction,,SHOP SALE,,-Split-,,"843,722.07"
,12/2/2022,Transaction,,Stephen Anderson,,EastX Bank,"-43,555.00","800,167.07"
,12/2/2022,Transaction,,Vere Harmsworth,,EastX Bank,-408,"799,759.07"
,12/2/2022,Transaction,,Ifzaal  Musa,,EastX Bank,"-10,000.00","789,759.07"
,15/02/2022,Receipt,12150,Online Sale,,Sales of Product Income:Non UK Sales,112.33,"789,871.40"
,15/02/2022,Receipt,12149,Online Sale,,Sales of Product Income:UK Sales,92,"789,963.40"
,15/02/2022,Receipt,12147,Online Sale,,Sales of Product Income:Non UK Sales,191.67,"790,155.07"
,15/02/2022,Receipt,12148,SHOP SALE,,Sales of Product Income:UK Sales,0,"790,155.07"
,15/02/2022,Transaction,,Online Sale,,EastX ****2310,-188.79,"789,966.28"
,15/02/2022,Transaction,,Online Sale,,Apple Account,-1.77,"789,964.51"
,15/02/2022,Transaction,,Online Sale,,EastX ****2310,-90.51,"789,874.00"
,15/02/2022,Transaction,,Online Sale,,Apple Account,-1.49,"789,872.51"
,15/02/2022,Transaction,,Online Sale,,Apple Account,-2.88,"789,869.63"
,15/02/2022,Transaction,,Online Sale,,EastX ****2310,-110.56,"789,759.07"
,16/02/2022,Receipt,12152,Online Sale,,Sales of Product Income:Non UK Sales,255,"790,014.07"
,16/02/2022,Receipt,12151,Online Sale,,Sales of Product Income:Non UK Sales,48.33,"790,062.40"
,16/02/2022,Transaction,,Gut Grambow SonySports GmbH,,EastX Bank,"-4,996.83","785,065.57"
,16/02/2022,Transaction,,Online Sale,,EastX ****2310,-46.73,"785,018.84"
,16/02/2022,Transaction,,Online Sale,,Apple Account,-7.6,"785,011.24"
,16/02/2022,Transaction,,Online Sale,,Apple Account,-1.6,"785,009.64"
,16/02/2022,Transaction,,Online Sale,,EastX ****2310,-247.4,"784,762.24"
,17/02/2022,Receipt,12155,Online Sale,,Sales of Product Income:Non UK Sales,50,"784,812.24"
,17/02/2022,Receipt,12154,Hannes Pickard,,Sales of Product Income:Non UK Sales,220,"785,032.24"
,17/02/2022,Receipt,12153,Online Sale,,Sales of Product Income:Non UK Sales,265,"785,297.24"
,17/02/2022,Transaction,,Online Sale,,EastX ****2310,-261.09,"785,036.15"
,17/02/2022,Transaction,,Online Sale,,EastX ****2310,-49.1,"784,987.05"
,17/02/2022,Transaction,,Online Sale,,Apple Account,-0.9,"784,986.15"
,17/02/2022,Transaction,,Online Sale,,Apple Account,-3.91,"784,982.24"
,17/02/2022,Transaction,,David Austin,,EastX Bank,"-7,900.00","777,082.24"
,18/02/2022,Receipt,12156,Gut Grambow SonySports GmbH,,Sales of Product Income:Non UK Sales,66,"777,148.24"
,22/02/2022,Receipt,12158,SHOP SALE,,Sales of Product Income:UK Sales,0,"777,148.24"
,22/02/2022,Receipt,12159,Paul F Barnhart Jr,,-Split-,"5,000.00","782,148.24"
,22/02/2022,Transaction,,Online Sale,,EastX ****2310,-558.54,"781,589.70"
,22/02/2022,Transaction,,Online Sale,,Apple Account,-8.13,"781,581.57"
,22/02/2022,Receipt,12157,Online Sale,,Sales of Product Income:Non UK Sales,566.67,"782,148.24"
,23/02/2022,Transaction,,Online Sale,,EastX ****2310,-107.42,"782,040.82"
,23/02/2022,Transaction,,Online Sale,,Apple Account,-3.41,"782,037.41"
,23/02/2022,Transaction,,Online Sale,,EastX ****2310,-229.86,"781,807.55"
,23/02/2022,Transaction,,Online Sale,,Apple Account,-2.86,"781,804.69"
,23/02/2022,Transaction,,Online Sale,,EastX ****2310,-135.37,"781,669.32"
,23/02/2022,Transaction,,Online Sale,,EastX ****2310,-88.81,"781,580.51"
,23/02/2022,Transaction,,Online Sale,,Apple Account,-3.47,"781,577.04"
,23/02/2022,Transaction,,Online Sale,,Apple Account,-2.13,"781,574.91"
,23/02/2022,Receipt,12160,Online Sale,,Sales of Product Income:Non UK Sales,91.67,"781,666.58"
,23/02/2022,Receipt,12163,David Austin,,Sales of Product Income:Non UK Sales,45,"781,711.58"
,23/02/2022,Receipt,12164,Online Sale,,Sales of Product Income:Non UK Sales,137.5,"781,849.08"
,23/02/2022,Receipt,12161,Online Sale,,Sales of Product Income:Non UK Sales,233.33,"782,082.41"
,23/02/2022,Receipt,12162,Online Sale,,Sales of Product Income:Non UK Sales,110.83,"782,193.24"
,24/02/2022,Receipt,12165,Online Sale,,Sales of Product Income:Non UK Sales,115,"782,308.24"
,24/02/2022,Receipt,12166,Sheikh Khalid Bin Ibrahim Al-Khalifa,,Sales of Product Income:Non UK Sales,"3,950.00","786,258.24"
,24/02/2022,Transaction,,Online Sale,,Apple Account,-3.54,"786,254.70"
,25/02/2022,Transaction,,Outdoor Outfitters,,EastX Bank,"-201,670.40","584,584.30"
,25/02/2022,Transaction,,Online Sale,,Apple Account,-1.13,"584,583.17"
,25/02/2022,Receipt,12171,Nelson Neto Junior,,-Split-,240,"584,823.17"
,25/02/2022,Receipt,12172,Online Sale,,Sales of Product Income:Non UK Sales,66.67,"584,889.84"
,26/02/2022,Receipt,12176,David Modesett,,-Split-,"38,110.00","622,999.84"
,26/02/2022,Receipt,12168,Thomas Hill,,Sales of Product Income:Non UK Sales,"5,000.00","627,999.84"
,26/02/2022,Receipt,12169,Stephen Anderson,,Sales of Product Income:Non UK Sales,"4,200.00","632,199.84"
,26/02/2022,Receipt,12175,Armurerie Collard,,Sales of Product Income:Non UK Sales,"6,230.00","638,429.84"
,26/02/2022,Receipt,12170,Brian Welker,,Sales of Product Income:Non UK Sales,"8,200.00","646,629.84"
,26/02/2022,Receipt,12173,Chris Russell,,Sales of Product Income:UK Sales,337,"646,966.84"
,26/02/2022,Receipt,12167,Vance Daigle,,Sales of Product Income:Non UK Sales,"2,062.00","649,028.84"
,26/02/2022,Receipt,12174,Viscount Jonathan Rothermere,,Sales of Product Income:UK Sales,"29,100.00","678,128.84"
,1/3/2022,Receipt,12181,Northwood Group Kft,,-Split-,"3,215.00","681,343.84"
,1/3/2022,Receipt,12178,Online Sale,,Sales of Product Income:UK Sales,242,"681,585.84"
,1/3/2022,Receipt,12177,Online Sale,,Sales of Product Income:Non UK Sales,107.5,"681,693.34"
,1/3/2022,Receipt,12179,Online Sale,,Sales of Product Income:Non UK Sales,66.67,"681,760.01"
,1/3/2022,Transaction,,Online Sale,,Apple Account,-3.59,"681,756.42"
,1/3/2022,Transaction,,Online Sale,,EastX ****2310,-238.41,"681,518.01"
,1/3/2022,Transaction,,Online Sale,,Apple Account,-1.71,"681,516.30"
,1/3/2022,Transaction,,Online Sale,,EastX ****2310,-111.46,"681,404.84"
,1/3/2022,Transaction,,Nelson Neto Junior,,EastX  Saver ****7829,-240,"681,164.84"
,1/3/2022,Transaction,,Online Sale,,EastX ****2310,-65.54,"681,099.30"
,1/3/2022,Transaction,,Online Sale,,EastX ****2310,-65.54,"681,033.76"
,1/3/2022,Transaction,,Online Sale,,Apple Account,-1.13,"681,032.63"
,1/3/2022,Transaction,,Online Sale,,EastX ****2310,-105.79,"680,926.84"
,2/3/2022,Receipt,12182,Online Sale,,Sales of Product Income:UK Sales,37,"680,963.84"
,2/3/2022,Receipt,12183,Online Sale,,Sales of Product Income:Non UK Sales,583.33,"681,547.17"
,2/3/2022,Transaction,,Chris Russell,,EastX Bank,-337,"681,210.17"
,2/3/2022,Transaction,,Online Sale,,EastX ****2310,-36.28,"681,173.89"
,2/3/2022,Transaction,,Online Sale,,Apple Account,-17.12,"681,156.77"
,2/3/2022,Transaction,,Online Sale,,Apple Account,-0.72,"681,156.05"
,2/3/2022,Transaction,,Online Sale,,EastX ****2310,-566.21,"680,589.84"
,3/3/2022,Receipt,12187,Armurerie Collard,,-Split-,995,"681,584.84"
,3/3/2022,Receipt,12186,Richard Kilby,,Sales of Product Income:Non UK Sales,470,"682,054.84"
,3/3/2022,Transaction,,Online Sale,,EastX ****2310,-95.28,"681,959.56"
,3/3/2022,Receipt,12185,Sheikh Salman Bin Ebrahim Al-Khalifa,,Sales of Product Income:Non UK Sales,600,"682,559.56"
,3/3/2022,Transaction,,Online Sale,,Apple Account,-3.05,"682,556.51"
,3/3/2022,Receipt,12184,Online Sale,,Sales of Product Income:Non UK Sales,98.33,"682,654.84"
,5/3/2022,Receipt,12191,Diggory Haddoke,,-Split-,579.6,"683,234.44"
,5/3/2022,Transaction,,David Austin,,EastX Bank,"-16,700.00","666,534.44"
,5/3/2022,Receipt,12188,The Traditional English cases Ltd,,Sales of Product Income:Non UK Sales,90,"666,624.44"
,8/3/2022,Receipt,12194,Online Sale,,Sales of Product Income:UK Sales,37,"666,661.44"
,8/3/2022,Receipt,12193,Online Sale,,Sales of Product Income:Non UK Sales,190.83,"666,852.27"
,8/3/2022,Receipt,12192,Online Sale,,Sales of Product Income:Non UK Sales,295.83,"667,148.10"
,8/3/2022,Transaction,,Online Sale,,Apple Account,-0.72,"667,147.38"
,8/3/2022,Transaction,,Online Sale,,EastX ****2310,-187.96,"666,959.42"
,8/3/2022,Transaction,,Online Sale,,Apple Account,-2.87,"666,956.55"
,8/3/2022,Transaction,,Online Sale,,Apple Account,-4.34,"666,952.21"
,8/3/2022,Transaction,,Thomas Hill,,Apple Account,-12,"666,940.21"
,8/3/2022,Transaction,,Thomas Hill,,EastX Bank,"-4,988.00","661,952.21"
,8/3/2022,Transaction,,Online Sale,,EastX ****2310,-36.28,"661,915.93"
,8/3/2022,Transaction,,Online Sale,,EastX ****2310,-291.49,"661,624.44"
,9/3/2022,Receipt,12202,David Austin,,-Split-,"4,178.00","665,802.44"
,9/3/2022,Transaction,,Online Sale,,Apple Account,-2.87,"665,799.57"
,9/3/2022,Receipt,12198,Online Sale,,Sales of Product Income:Non UK Sales,357.5,"666,157.07"
,9/3/2022,Receipt,12197,Online Sale,,Sales of Product Income:Non UK Sales,295.83,"666,452.90"
,9/3/2022,Receipt,12195,Online Sale,,-Split-,236,"666,688.90"
,9/3/2022,Receipt,12201,Online Sale,,Sales of Product Income:Non UK Sales,190.83,"666,879.73"
,9/3/2022,Receipt,12199,Tommy Salmon,,Orders in Hand/Deferred Income,"8,544.57","675,424.30"
,9/3/2022,Receipt,12196,Online Sale,,Sales of Product Income:Non UK Sales,342.5,"675,766.80"
,9/3/2022,Receipt,12203,SHOP SALE,,Sales of Product Income:UK Sales,0,"675,766.80"
,9/3/2022,Transaction,,Tommy Salmon,,EastX Bank,"-8,544.57","667,222.23"
,9/3/2022,Transaction,,Online Sale,,EastX ****2310,-352.29,"666,869.94"
,9/3/2022,Transaction,,Online Sale,,Apple Account,-5.21,"666,864.73"
,9/3/2022,Transaction,,Online Sale,,EastX ****2310,-291.49,"666,573.24"
,9/3/2022,Transaction,,Online Sale,,Apple Account,-5,"666,568.24"
,9/3/2022,Transaction,,Online Sale,,Apple Account,-3.5,"666,564.74"
,9/3/2022,Transaction,,Online Sale,,EastX ****2310,-232.5,"666,332.24"
,9/3/2022,Transaction,,Online Sale,,Apple Account,-4.34,"666,327.90"
,9/3/2022,Transaction,,Online Sale,,Apple Account,-3.95,"666,323.95"
,9/3/2022,Transaction,,Online Sale,,EastX ****2310,-125.22,"666,198.73"
,9/3/2022,Transaction,,Darach Albannach limited,,EastX Bank,"-4,263.00","661,935.73"
,9/3/2022,Transaction,,Online Sale,,EastX ****2310,-337.5,"661,598.23"
,9/3/2022,Transaction,,Brian Welker,,EastX ****2310,"-8,044.20","653,554.03"
,9/3/2022,Transaction,,Online Sale,,EastX ****2310,-187.96,"653,366.07"
,9/3/2022,Receipt,12200,Online Sale,,Sales of Product Income:Non UK Sales,129.17,"653,495.24"
,10/3/2022,Receipt,12205,Online Sale,,Sales of Product Income:Non UK Sales,295.83,"653,791.07"
,10/3/2022,Receipt,12204,Outdoor Outfitters,,-Split-,422,"654,213.07"
,10/3/2022,Receipt,12206,Jamie Williams,,-Split-,77.2,"654,290.27"
,10/3/2022,Transaction,,Online Sale,,Apple Account,-4.34,"654,285.93"
,10/3/2022,Transaction,,Stephen Anderson,,EastX Bank,"-4,200.00","650,085.93"
,10/3/2022,Transaction,,Brian Welker,,Apple Account,-155.8,"649,930.13"
,10/3/2022,Transaction,,Online Sale,,EastX ****2310,-291.49,"649,638.64"
,10/3/2022,Transaction,,Jamie Williams,,EastX  Saver ****7829,-77.2,"649,561.44"
,11/3/2022,Receipt,12207,Sheikh Salman Bin Ebrahim Al-Khalifa,,Sales of Product Income:UK Sales,"1,970.00","651,531.44"
,12/3/2022,Receipt,12209,Stephen Anderson,,Sales of Product Income:Non UK Sales,170,"651,701.44"
,12/3/2022,Receipt,12210,Online Sale,,Sales of Product Income:Non UK Sales,56.67,"651,758.11"
,12/3/2022,Transaction,,Online Sale,,EastX ****2310,-54.83,"651,703.28"
,12/3/2022,Transaction,,Online Sale,,Apple Account,-1.84,"651,701.44"
,12/3/2022,Receipt,12208,Armurerie Collard,,Sales of Product Income:Non UK Sales,120,"651,821.44"
,15/03/2022,Transaction,,Online Sale,,Apple Account,-1.53,"651,819.91"
,15/03/2022,Transaction,,Online Sale,,EastX ****2310,-111.46,"651,708.45"
,15/03/2022,Transaction,,Online Sale,,Apple Account,-19.73,"651,688.72"
,15/03/2022,Receipt,12216,National Crime Agency,PO00068231,Sales of Product Income:UK Sales,444,"652,132.72"
,15/03/2022,Receipt,12215,Paul F Barnhart Jr,,-Split-,"4,909.00","657,041.72"
,15/03/2022,Receipt,12211,Online Sale,,Sales of Product Income:Non UK Sales,252.5,"657,294.22"
,15/03/2022,Receipt,12214,Online Sale,,Sales of Product Income:Non UK Sales,95,"657,389.22"
,15/03/2022,Receipt,12213,Online Sale,,Sales of Product Income:Non UK Sales,115,"657,504.22"
,15/03/2022,Receipt,12212,Online Sale,,Sales of Product Income:Non UK Sales,673.33,"658,177.55"
,15/03/2022,Receipt,12218,SHOP SALE,,Sales of Product Income:UK Sales,49,"658,226.55"
,15/03/2022,Receipt,12217,Mr Marc Newton,,Sales of Product Income:UK Sales,42.24,"658,268.79"
,15/03/2022,Transaction,,Online Sale,,EastX ****2310,-653.6,"657,615.19"
,15/03/2022,Transaction,,Online Sale,,EastX ****2310,-244.98,"657,370.21"
,15/03/2022,Transaction,,SHOP SALE,,EastX  Saver ****7829,-49,"657,321.21"
,15/03/2022,Transaction,,Online Sale,,Apple Account,-3.54,"657,317.67"
,15/03/2022,Transaction,,Online Sale,,EastX ****2310,-93.47,"657,224.20"
,15/03/2022,Transaction,,Online Sale,,Apple Account,-7.52,"657,216.68"
,16/03/2022,Transaction,,Online Sale,,Apple Account,-8.95,"657,207.73"
,16/03/2022,Transaction,,Online Sale,,EastX ****2310,-616.05,"656,591.68"
,16/03/2022,Receipt,12219,Online Sale,,Sales of Product Income:Non UK Sales,625,"657,216.68"
,16/03/2022,Transaction,,Sheikh Khalid Bin Ibrahim Al-Khalifa,,EastX Bank,"-8,562.77","648,653.91"
,16/03/2022,Transaction,,Armurerie Collard,,EastX Bank,-518,"648,135.91"
,17/03/2022,Transaction,,Online Sale,,EastX ****2310,-207.85,"647,928.06"
,17/03/2022,Receipt,12220,Outdoor Outfitters,,-Split-,83,"648,011.06"
,17/03/2022,Receipt,12221,Online Sale,,Sales of Product Income:UK Sales,211,"648,222.06"
,17/03/2022,Transaction,,Online Sale,,Apple Account,-3.15,"648,218.91"
,18/03/2022,Transaction,,Vance Daigle,,EastX Bank,"-2,062.00","646,156.91"
,18/03/2022,Transaction,,Online Sale,,Apple Account,-3.87,"646,153.04"
,18/03/2022,Receipt,12222,JAFI,,-Split-,325,"646,478.04"
,18/03/2022,Receipt,12223,Online Sale,,Sales of Product Income:UK Sales,262,"646,740.04"
,18/03/2022,Transaction,,Online Sale,,EastX ****2310,-258.13,"646,481.91"
,19/03/2022,Transaction,,Online Sale,,Apple Account,-3.27,"646,478.64"
,19/03/2022,Transaction,,Online Sale,,EastX ****2310,-102.56,"646,376.08"
,19/03/2022,Transaction,,Online Sale,,Apple Account,-1.54,"646,374.54"
,19/03/2022,Receipt,12229,Online Sale,,Sales of Product Income:UK Sales,96,"646,470.54"
,19/03/2022,Transaction,,Paul F Barnhart Jr,,EastX Bank,"-9,909.00","636,561.54"
,19/03/2022,Receipt,12225,Simon Barr,,-Split-,240.6,"636,802.14"
,19/03/2022,Receipt,12224,Online Sale,,Sales of Product Income:Non UK Sales,105.83,"636,907.97"
,19/03/2022,Transaction,,Online Sale,,EastX ****2310,-94.46,"636,813.51"
,22/03/2022,Transaction,,Online Sale,,EastX ****2310,-78.29,"636,735.22"
,22/03/2022,Transaction,,Online Sale,,Apple Account,-2.54,"636,732.68"
,22/03/2022,Receipt,12233,Lee Butler Gun & Rifle Makers,,Sales of Product Income:UK Sales,600,"637,332.68"
,22/03/2022,Receipt,12231,Sidney Hiscox,,Sales of Product Income:UK Sales,"2,766.00","640,098.68"
,22/03/2022,Receipt,12230,Online Sale,,Sales of Product Income:Non UK Sales,80.83,"640,179.51"
,22/03/2022,Receipt,12232,Simon Barr,,Sales of Product Income:UK Sales,330,"640,509.51"
,23/03/2022,Receipt,12235,Online Sale,,Sales of Product Income:UK Sales,65,"640,574.51"
,23/03/2022,Receipt,12234,Online Sale,,Sales of Product Income:Non UK Sales,45.83,"640,620.34"
,23/03/2022,Receipt,12237,Online Sale,,Sales of Product Income:Non UK Sales,115,"640,735.34"
,23/03/2022,Receipt,12236,Ve?koobchod zbrane spol. s.r.o.,,Orders in Hand/Deferred Income,"5,000.00","645,735.34"
,23/03/2022,Transaction,,David Austin,,EastX Bank,"-3,762.29","641,973.05"
,23/03/2022,Transaction,,Online Sale,,EastX ****2310,-111.46,"641,861.59"
,23/03/2022,Transaction,,Online Sale,,Apple Account,-1.11,"641,860.48"
,23/03/2022,Transaction,,Online Sale,,Apple Account,-0.84,"641,859.64"
,23/03/2022,Transaction,,Online Sale,,EastX ****2310,-44.99,"641,814.65"
,23/03/2022,Transaction,,Online Sale,,Apple Account,-3.54,"641,811.11"
,23/03/2022,Transaction,,Online Sale,,EastX ****2310,-63.89,"641,747.22"
,24/03/2022,Receipt,12244,Online Sale,,Sales of Product Income:Non UK Sales,122.5,"641,869.72"
,24/03/2022,Transaction,,Online Sale,,EastX ****2310,-118.75,"641,750.97"
,24/03/2022,Receipt,12242,HH Sheikh Mohammed Al-Sharqi,,Orders in Hand/Deferred Income,"50,000.00","691,750.97"
,24/03/2022,Receipt,12241,HH Sheikh Mohammed Al-Sharqi,,Orders in Hand/Deferred Income,"50,000.00","741,750.97"
,24/03/2022,Receipt,12239,HH Sheikh Mohammed Al-Sharqi,,Orders in Hand/Deferred Income,"15,000.00","756,750.97"
,24/03/2022,Receipt,12254,Edward Jonkler,,Sales of Product Income:UK Sales,690,"757,440.97"
,24/03/2022,Receipt,12253,SHOP SALE,,Sales of Product Income:Non UK Sales,0,"757,440.97"
,24/03/2022,Receipt,12245,Online Sale,,Sales of Product Income:UK Sales,92,"757,532.97"
,24/03/2022,Receipt,12240,HH Sheikh Mohammed Al-Sharqi,,Orders in Hand/Deferred Income,"50,000.00","807,532.97"
,24/03/2022,Receipt,12238,Derek Paul,,-Split-,300,"807,832.97"
,24/03/2022,Receipt,12226,Northwood USA 1,,-Split-,"89,946.00","897,778.97"
,24/03/2022,Transaction,,Online Sale,,Apple Account,-3.75,"897,775.22"
,24/03/2022,Transaction,,Outdoor Outfitters,,EastX Bank,-422,"897,353.22"
,24/03/2022,Transaction,,Online Sale,,Apple Account,-1.49,"897,351.73"
,24/03/2022,Transaction,,Online Sale,,EastX ****2310,-90.51,"897,261.22"
,24/03/2022,Receipt,12243,HH Sheikh Mohammed Al-Sharqi,,Orders in Hand/Deferred Income,"50,000.00","947,261.22"
,25/03/2022,Receipt,12256,Derek Paul,,-Split-,162,"947,423.22"
,25/03/2022,Receipt,12255,Online Sale,,Sales of Product Income:Non UK Sales,510.83,"947,934.05"
,25/03/2022,Receipt,12257,Online Sale,,-Split-,207,"948,141.05"
,25/03/2022,Transaction,,HH Sheikh Mohammed Al-Sharqi,,EastX Bank,"-99,988.00","848,153.05"
,25/03/2022,Transaction,,HH Sheikh Mohammed Al-Sharqi,,Apple Account,-12,"848,141.05"
,25/03/2022,Transaction,,Online Sale,,Apple Account,-15.01,"848,126.04"
,25/03/2022,Transaction,,Online Sale,,EastX ****2310,-203.9,"847,922.14"
,25/03/2022,Transaction,,Online Sale,,Apple Account,-3.1,"847,919.04"
,25/03/2022,Transaction,,Online Sale,,EastX ****2310,-495.82,"847,423.22"
,25/03/2022,Transaction,,David Austin,,EastX Bank,"-5,353.00","842,070.22"
,26/03/2022,Receipt,12258,Online Sale,,Sales of Product Income:Non UK Sales,80.83,"842,151.05"
,26/03/2022,Transaction,,Online Sale,,EastX ****2310,-78.29,"842,072.76"
,26/03/2022,Transaction,,Online Sale,,Apple Account,-2.54,"842,070.22"
,26/03/2022,Receipt,12259,Waffen Ortner,,-Split-,510,"842,580.22"
,29/03/2022,Receipt,12260,SHOP SALE,,Sales of Product Income:UK Sales,99,"842,679.22"
,29/03/2022,Receipt,12261,Online Sale,,Sales of Product Income:UK Sales,82,"842,761.22"
,29/03/2022,Transaction,,Online Sale,,Apple Account,-1.35,"842,759.87"
,29/03/2022,Receipt,12262,SHOP SALE,,Sales of Product Income:Non UK Sales,0,"842,759.87"
,29/03/2022,Receipt,12263,HH Sheikh Mohammed Al-Sharqi,,Sales of Product Income:Non UK Sales,0,"842,759.87"
,30/03/2022,Receipt,12268,Sheikh Salman Bin Ebrahim Al-Khalifa,,-Split-,680,"843,439.87"
,30/03/2022,Receipt,12267,Online Sale,,Sales of Product Income:Non UK Sales,350,"843,789.87"
,30/03/2022,Receipt,12266,Northwood USA 1,,Sales of Product Income:Non UK Sales,"2,984.00","846,773.87"
,30/03/2022,Receipt,12265,Sheikh Khalid Bin Ibrahim Al-Khalifa,,Orders in Hand/Deferred Income,"15,000.00","861,773.87"
,30/03/2022,Receipt,12264,Online Sale,,Sales of Product Income:UK Sales,27,"861,800.87"
,30/03/2022,Transaction,,Online Sale,,Apple Account,-10.35,"861,790.52"
,30/03/2022,Receipt,12269,Viscount John  Massereene & Ferrard,,-Split-,450,"862,240.52"
,30/03/2022,Transaction,,Sheikh Khalid Bin Ibrahim Al-Khalifa,,EastX Bank,"-15,000.00","847,240.52"
,30/03/2022,Transaction,,Online Sale,,Apple Account,-0.58,"847,239.94"
,30/03/2022,Transaction,,National Crime Agency,,EastX Bank,-444,"846,795.94"
,30/03/2022,Receipt,12270,Chris Dianda,,-Split-,"49,450.00","896,245.94"
,31/03/2022,Receipt,12271,Mary,,Sales of Product Income:Non UK Sales,35.2,"896,281.14"
,31/03/2022,Receipt,12272,Gut Grambow SonySports GmbH,,-Split-,450,"896,731.14"
,31/03/2022,Transaction,,Armurerie Collard,,EastX Bank,-120,"896,611.14"
,31/03/2022,Receipt,12227,Don Alberto Bailleres Gonzalez,,Sales of Product Income:Non UK Sales,"12,800.00","909,411.14"
,31/03/2022,Transaction,,Ifzaal  Musa,,EastX Bank,"-12,369.00","897,042.14"
,31/03/2022,Receipt,12228,Armurerie Richard,,Sales of Product Income:Non UK Sales,"6,000.00","903,042.14"
,1/4/2022,Receipt,12273,David Austin,,-Split-,870,"903,912.14"
,1/4/2022,Transaction,,SHOP SALE,,EastX  Saver ****7829,-99,"903,813.14"
,1/4/2022,Transaction,,Derek Paul,,-Split-,0,"903,813.14"
,1/4/2022,Transaction,,Online Sale,,EastX ****2310,-157.59,"903,655.55"
,1/4/2022,Transaction,,Online Sale,,EastX ****2310,-339.65,"903,315.90"
,1/4/2022,Receipt,12275,Online Sale,,Sales of Product Income:Non UK Sales,162.5,"903,478.40"
,1/4/2022,Transaction,,Mary,,EastX  Saver ****7829,-35.2,"903,443.20"
,1/4/2022,Transaction,,Online Sale,,EastX ****2310,-80.65,"903,362.55"
,1/4/2022,Debit Memo,12274,Derek Paul,,Sales of Product Income:Non UK Sales,-50,"903,312.55"
,1/4/2022,Transaction,,Chris Dianda,,EastX  Saver ****7829,"-50,000.00","853,312.55"
,1/4/2022,Transaction,,Online Sale,,Apple Account,-4.91,"853,307.64"
,2/4/2022,Transaction,,Online Sale,,EastX ****2310,-224.11,"853,083.53"
,2/4/2022,Receipt,12277,Online Sale,,Sales of Product Income:Non UK Sales,227.5,"853,311.03"
,2/4/2022,Transaction,,Online Sale,,EastX ****2310,-26.42,"853,284.61"
,2/4/2022,Transaction,,Online Sale,,Apple Account,-3.39,"853,281.22"
,2/4/2022,Transaction,,Ve?koobchod zbrane spol. s.r.o.,,EastX Bank,"-5,000.00","848,281.22"
,6/4/2022,Transaction,,Online Sale,,EastX ****2310,-225.76,"848,055.46"
,6/4/2022,Transaction,,Online Sale,,EastX ****2310,-332.08,"847,723.38"
,6/4/2022,Transaction,,Online Sale,,Apple Account,-5.17,"847,718.21"
,6/4/2022,Transaction,,Online Sale,,EastX ****2310,-349.83,"847,368.38"
,6/4/2022,Transaction,,Online Sale,,Apple Account,-4.92,"847,363.46"
,6/4/2022,Transaction,,Online Sale,,Apple Account,-3.41,"847,360.05"
,6/4/2022,Transaction,,Online Sale,,EastX ****2310,-134.93,"847,225.12"
,6/4/2022,Receipt,12280,Online Sale,,Sales of Product Income:Non UK Sales,355,"847,580.12"
,6/4/2022,Receipt,12281,Online Sale,,Sales of Product Income:Non UK Sales,139.17,"847,719.29"
,6/4/2022,Receipt,12278,Online Sale,,Sales of Product Income:Non UK Sales,229.17,"847,948.46"
,6/4/2022,Receipt,12282,Paul F Barnhart Jr,,-Split-,"5,000.00","852,948.46"
,6/4/2022,Receipt,12279,Online Sale,,Sales of Product Income:UK Sales,337,"853,285.46"
,6/4/2022,Transaction,,Online Sale,,Apple Account,-4.24,"853,281.22"
,7/4/2022,Transaction,,Online Sale,,EastX ****2310,-122.23,"853,158.99"
,7/4/2022,Receipt,12285,Simon Raynard,,-Split-,153.5,"853,312.49"
,7/4/2022,Receipt,12284,SHOP SALE,,-Split-,255.95,"853,568.44"
,7/4/2022,Receipt,12283,Online Sale,,Sales of Product Income:Non UK Sales,124.17,"853,692.61"
,7/4/2022,Transaction,,Online Sale,,Apple Account,-1.94,"853,690.67"
,8/4/2022,Receipt,12286,Online Sale,,Sales of Product Income:Non UK Sales,107.5,"853,798.17"
,8/4/2022,Transaction,,Simon Raynard,,EastX Bank,-153.5,"853,644.67"
,8/4/2022,Transaction,,Online Sale,,Apple Account,-1.71,"853,642.96"
,8/4/2022,Transaction,,JAFI,,EastX Bank,-325,"853,317.96"
,8/4/2022,Transaction,,Online Sale,,EastX ****2310,-105.79,"853,212.17"
,9/4/2022,Receipt,12293,Online Sale,,Sales of Product Income:Non UK Sales,239,"853,451.17"
,9/4/2022,Receipt,12294,Online Sale,,Sales of Product Income:Non UK Sales,81.67,"853,532.84"
,9/4/2022,Receipt,12291,Dr Eckard Stief,,Sales of Product Income:Non UK Sales,"1,050.00","854,582.84"
,9/4/2022,Receipt,12288,Online Sale,,Sales of Product Income:Non UK Sales,206.67,"854,789.51"
,9/4/2022,Receipt,12290,Stephen Anderson,,Sales of Product Income:Non UK Sales,170,"854,959.51"
,9/4/2022,Transaction,,Nelson Neto Junior,,Apple Account,-4.48,"854,955.03"
,9/4/2022,Transaction,,Online Sale,,Apple Account,-6.19,"854,948.84"
,9/4/2022,Transaction,,Online Sale,,EastX ****2310,-79.1,"854,869.74"
,9/4/2022,Transaction,,Online Sale,,EastX ****2310,-200.48,"854,669.26"
,9/4/2022,Transaction,,Paul F Barnhart Jr,,EastX Bank,"-5,000.00","849,669.26"
,9/4/2022,Transaction,,Online Sale,,EastX ****2310,-231.87,"849,437.39"
,9/4/2022,Transaction,,SHOP SALE,,EastX Bank,-255.95,"849,181.44"
,9/4/2022,Transaction,,Online Sale,,Apple Account,-7.13,"849,174.31"
,9/4/2022,Transaction,,Derek Paul,,EastX Bank,-409.35,"848,764.96"
,9/4/2022,Transaction,,Online Sale,,Apple Account,-2.57,"848,762.39"
,9/4/2022,Debit Memo,12292,Derek Paul,,Sales of Product Income:Non UK Sales,-2.65,"848,759.74"
,12/4/2022,Receipt,12295,Online Sale,,Sales of Product Income:Non UK Sales,337,"849,096.74"
,12/4/2022,Transaction,,Online Sale,,Apple Account,-4.92,"849,091.82"
,12/4/2022,Transaction,,Online Sale,,EastX ****2310,-332.08,"848,759.74"
,12/4/2022,Transaction,,Derek Paul,,-Split-,,"848,759.74"
,13/04/2022,Receipt,12296,Online Sale,,Sales of Product Income:Non UK Sales,152.5,"848,912.24"
,13/04/2022,Receipt,12297,Online Sale,,Sales of Product Income:Non UK Sales,210.83,"849,123.07"
,13/04/2022,Receipt,12298,Online Sale,,Sales of Product Income:Non UK Sales,60.83,"849,183.90"
,13/04/2022,Transaction,,Online Sale,,Apple Account,-1.96,"849,181.94"
,13/04/2022,Transaction,,Online Sale,,EastX ****2310,-58.87,"849,123.07"
,13/04/2022,Transaction,,Online Sale,,EastX ****2310,-147.88,"848,975.19"
,13/04/2022,Transaction,,Online Sale,,Apple Account,-4.62,"848,970.57"
,13/04/2022,Transaction,,Online Sale,,EastX ****2310,-204.52,"848,766.05"
,13/04/2022,Transaction,,L&O Group SA,,EastX Bank,"-4,017.00","844,749.05"
,13/04/2022,Transaction,,Online Sale,,Apple Account,-6.31,"844,742.74"
,14/04/2022,Receipt,12302,Online Sale,,Sales of Product Income:Non UK Sales,155.83,"844,898.57"
,14/04/2022,Transaction,,Online Sale,,EastX ****2310,-241.58,"844,656.99"
,14/04/2022,Receipt,12299,SHOP SALE,,-Split-,219,"844,875.99"
,14/04/2022,Receipt,12304,Online Sale,,-Split-,211,"845,086.99"
,14/04/2022,Receipt,12303,Online Sale,,Sales of Product Income:Non UK Sales,249,"845,335.99"
,14/04/2022,Receipt,12301,Online Sale,,Sales of Product Income:Non UK Sales,80,"845,415.99"
,14/04/2022,Transaction,,Online Sale,,Apple Account,-7.42,"845,408.57"
,14/04/2022,Transaction,,Online Sale,,Apple Account,-2.52,"845,406.05"
,14/04/2022,Transaction,,Online Sale,,Apple Account,-3.15,"845,402.90"
,14/04/2022,Transaction,,Online Sale,,EastX ****2310,-77.48,"845,325.42"
,14/04/2022,Transaction,,The Traditional English cases Ltd,,EastX Bank,-90,"845,235.42"
,14/04/2022,Transaction,,Online Sale,,EastX ****2310,-207.85,"845,027.57"
,14/04/2022,Transaction,,David Modesett,,EastX Bank,"-38,110.00","806,917.57"
,14/04/2022,Transaction,,Online Sale,,Apple Account,-2.38,"806,915.19"
,14/04/2022,Transaction,,Online Sale,,EastX ****2310,-153.45,"806,761.74"
,14/04/2022,Transaction,,SHOP SALE,,EastX  Saver ****7829,-219,"806,542.74"
,14/04/2022,Transaction,,Online Sale,,Apple Account,-1.83,"806,540.91"
,14/04/2022,Transaction,,Online Sale,,EastX ****2310,-114.84,"806,426.07"
,14/04/2022,Receipt,12300,Online Sale,,Sales of Product Income:Non UK Sales,116.67,"806,542.74"
,15/04/2022,Receipt,12306,Outdoor Outfitters,,-Split-,80,"806,622.74"
,15/04/2022,Transaction,,Nelson Neto Junior,,EastX  Saver ****7829,-22.4,"806,600.34"
,15/04/2022,Receipt,12305,Nelson Neto Junior,,Sales of Product Income:UK Sales,26.88,"806,627.22"
,16/04/2022,Receipt,12307,Northwood Group Kft,,-Split-,466,"807,093.22"
,16/04/2022,Receipt,12308,Online Sale,,-Split-,92,"807,185.22"
,16/04/2022,Transaction,,Online Sale,,Apple Account,-1.49,"807,183.73"
,16/04/2022,Transaction,,Viscount John  Massereene & Ferrard,,EastX ****2310,-450,"806,733.73"
,16/04/2022,Transaction,,Online Sale,,EastX ****2310,-90.51,"806,643.22"
,16/04/2022,Receipt,12309,Simon Raynard,,-Split-,54.24,"806,697.46"
,19/04/2022,Receipt,12310,Online Sale,,Sales of Product Income:Non UK Sales,295.83,"806,993.29"
,19/04/2022,Transaction,,Online Sale,,Apple Account,-4.34,"806,988.95"
,19/04/2022,Receipt,12314,SHOP SALE,,Sales of Product Income:Non UK Sales,60,"807,048.95"
,19/04/2022,Receipt,12313,Northwood Group UK,,-Split-,162,"807,210.95"
,19/04/2022,Receipt,12315,Online Sale,,Sales of Product Income:Non UK Sales,295.83,"807,506.78"
,19/04/2022,Receipt,12312,Online Sale,,Sales of Product Income:Non UK Sales,69,"807,575.78"
,19/04/2022,Transaction,,Online Sale,,EastX ****2310,-66.8,"807,508.98"
,19/04/2022,Transaction,,Online Sale,,Apple Account,-1.48,"807,507.50"
,19/04/2022,Transaction,,JAFI,,EastX Bank,-50,"807,457.50"
,19/04/2022,Transaction,,Gut Grambow SonySports GmbH,,EastX Bank,-825,"806,632.50"
,19/04/2022,Transaction,,Online Sale,,Apple Account,-4.34,"806,628.16"
,19/04/2022,Transaction,,SHOP SALE,,EastX  Saver ****7829,-60,"806,568.16"
,19/04/2022,Transaction,,Online Sale,,EastX ****2310,-291.49,"806,276.67"
,19/04/2022,Transaction,,Online Sale,,Apple Account,-2.2,"806,274.47"
,19/04/2022,Transaction,,Online Sale,,EastX ****2310,-90.19,"806,184.28"
,19/04/2022,Transaction,,Online Sale,,EastX ****2310,-291.49,"805,892.79"
,19/04/2022,Receipt,12311,Online Sale,,Sales of Product Income:Non UK Sales,91.67,"805,984.46"
,20/04/2022,Receipt,12317,Online Sale,,Sales of Product Income:UK Sales,512,"806,496.46"
,20/04/2022,Receipt,12316,Online Sale,,Sales of Product Income:Non UK Sales,124.17,"806,620.63"
,20/04/2022,Debit Memo,CN 11188,Francisco D'Agostino,,Sales of Product Income:Non UK Sales,"-25,510.40","781,110.23"
,20/04/2022,Debit Memo,CN 10618,Francisco D'Agostino,,Sales of Product Income:Non UK Sales,"-26,170.40","754,939.83"
,20/04/2022,Transaction,,Francisco D'Agostino,,-Split-,,"754,939.83"
,20/04/2022,Transaction,,Online Sale,,Apple Account,-7.37,"754,932.46"
,20/04/2022,Transaction,,Online Sale,,EastX ****2310,-122.23,"754,810.23"
,20/04/2022,Transaction,,Online Sale,,EastX ****2310,-504.63,"754,305.60"
,20/04/2022,Transaction,,Online Sale,,Apple Account,-1.94,"754,303.66"
,20/04/2022,Transaction,,Francisco D'Agostino,,-Split-,0,"754,303.66"
,21/04/2022,Receipt,12318,Online Sale,,Sales of Product Income:UK Sales,32,"754,335.66"
,21/04/2022,Receipt,12323,Giancarlo Lugli,,Orders in Hand/Deferred Income,"1,000.00","755,335.66"
,21/04/2022,Receipt,12321,The Traditional English cases Ltd,,Sales of Product Income:Sales,77.39,"755,413.05"
,21/04/2022,Receipt,12322,Nelson Neto Junior,,Sales of Product Income:UK Sales,16.38,"755,429.43"
,21/04/2022,Receipt,12319,Online Sale,,Sales of Product Income:Non UK Sales,194.17,"755,623.60"
,21/04/2022,Receipt,12320,SHOP SALE,,Sales of Product Income:Non UK Sales,60,"755,683.60"
,21/04/2022,Transaction,,Online Sale,,EastX ****2310,-21.16,"755,662.44"
,21/04/2022,Transaction,,Nelson Neto Junior,,EastX  Saver ****7829,-16.38,"755,646.06"
,21/04/2022,Transaction,,Online Sale,,Apple Account,-0.84,"755,645.22"
,21/04/2022,Transaction,,Online Sale,,EastX ****2310,-188.34,"755,456.88"
,21/04/2022,Transaction,,Online Sale,,Apple Account,-5.83,"755,451.05"
,21/04/2022,Transaction,,Online Sale,,Apple Account,-0.65,"755,450.40"
,21/04/2022,Transaction,,Online Sale,,EastX ****2310,-31.35,"755,419.05"
,21/04/2022,Receipt,12324,Online Sale,,Sales of Product Income:UK Sales,22,"755,441.05"
,22/04/2022,Receipt,12333,Nigel Gillman,,Sales of Product Income:Sales,936,"756,377.05"
,22/04/2022,Transaction,,Simon Raynard,,EastX Bank,-54.24,"756,322.81"
,22/04/2022,Receipt,12329,Online Sale,,Sales of Product Income:Non UK Sales,245.83,"756,568.64"
,22/04/2022,Receipt,12327,Online Sale,,Sales of Product Income:Non UK Sales,295.83,"756,864.47"
,22/04/2022,Receipt,12328,Online Sale,,Sales of Product Income:Non UK Sales,145,"757,009.47"
,22/04/2022,Receipt,12332,Online Sale,,Sales of Product Income:Non UK Sales,45.83,"757,055.30"
,22/04/2022,Receipt,12331,SHOP SALE,,Sales of Product Income:UK Sales,13.5,"757,068.80"
,22/04/2022,Receipt,12326,Online Sale,,Sales of Product Income:UK Sales,91,"757,159.80"
,22/04/2022,Receipt,12325,Online Sale,,Sales of Product Income:Non UK Sales,650,"757,809.80"
,22/04/2022,Transaction,,Online Sale,,Apple Account,-1.47,"757,808.33"
,22/04/2022,Transaction,,Online Sale,,Apple Account,-4.02,"757,804.31"
,22/04/2022,Transaction,,Online Sale,,Apple Account,-4.41,"757,799.90"
,22/04/2022,Transaction,,Online Sale,,Apple Account,-4.34,"757,795.56"
,22/04/2022,Transaction,,Online Sale,,Apple Account,-9.3,"757,786.26"
,22/04/2022,Transaction,,Online Sale,,EastX ****2310,-127.65,"757,658.61"
,22/04/2022,Transaction,,Online Sale,,EastX ****2310,-89.53,"757,569.08"
,22/04/2022,Transaction,,Online Sale,,Apple Account,-0.84,"757,568.24"
,22/04/2022,Transaction,,Online Sale,,EastX ****2310,-44.99,"757,523.25"
,22/04/2022,Transaction,,Online Sale,,Apple Account,-3.64,"757,519.61"
,22/04/2022,Transaction,,Online Sale,,EastX ****2310,-242.19,"757,277.42"
,22/04/2022,Transaction,,Online Sale,,EastX ****2310,-140.59,"757,136.83"
,22/04/2022,Transaction,,Online Sale,,EastX ****2310,-640.7,"756,496.13"
,22/04/2022,Transaction,,SHOP SALE,,EastX  Saver ****7829,-13.5,"756,482.63"
,22/04/2022,Transaction,,Online Sale,,EastX ****2310,-291.49,"756,191.14"
,22/04/2022,Receipt,12330,Online Sale,,Sales of Product Income:Non UK Sales,131.67,"756,322.81"
,23/04/2022,Receipt,12383,The Traditional English cases Ltd,,Sales of Product Income:Sales,214.26,"756,537.07"
,23/04/2022,Receipt,12335,Online Sale,,Sales of Product Income:Non UK Sales,180.83,"756,717.90"
,23/04/2022,Receipt,12336,Online Sale,,Sales of Product Income:Non UK Sales,62.5,"756,780.40"
,23/04/2022,Receipt,12334,Online Sale,,Sales of Product Income:Non UK Sales,131.67,"756,912.07"
,23/04/2022,Transaction,,David Austin,,EastX Bank,"-8,800.00","748,112.07"
,23/04/2022,Transaction,,Nigel Gillman,,EastX  Saver ****7829,-936,"747,176.07"
,23/04/2022,Transaction,,Online Sale,,EastX ****2310,-61.42,"747,114.65"
,23/04/2022,Transaction,,Online Sale,,Apple Account,-1.08,"747,113.57"
,23/04/2022,Transaction,,Online Sale,,EastX ****2310,-127.65,"746,985.92"
,23/04/2022,Transaction,,Online Sale,,Apple Account,-5.44,"746,980.48"
,23/04/2022,Transaction,,Online Sale,,EastX ****2310,-175.39,"746,805.09"
,23/04/2022,Transaction,,Online Sale,,Apple Account,-4.02,"746,801.07"
,26/04/2022,Receipt,12346,John Doe,,Orders in Hand/Deferred Income,"4,697.50","751,498.57"
,26/04/2022,Transaction,,Online Sale,,EastX ****2310,-229.86,"751,268.71"
,26/04/2022,Receipt,12337,Online Sale,,Sales of Product Income:Non UK Sales,165,"751,433.71"
,26/04/2022,Receipt,12338,Online Sale,,Sales of Product Income:UK Sales,82,"751,515.71"
,26/04/2022,Receipt,12339,Online Sale,,Sales of Product Income:Non UK Sales,233.33,"751,749.04"
,26/04/2022,Receipt,12340,Online Sale,,Sales of Product Income:Non UK Sales,441.67,"752,190.71"
,26/04/2022,Receipt,12341,Mark Renmant,,Sales of Product Income:UK Sales,87.12,"752,277.83"
,26/04/2022,Transaction,,John Doe,,Cash Reserve,"-4,697.50","747,580.33"
,26/04/2022,Transaction,,Online Sale,,Apple Account,-1.35,"747,578.98"
,26/04/2022,Transaction,,Online Sale,,Apple Account,-6.38,"747,572.60"
,26/04/2022,Transaction,,SHOP SALE,,EastX  Saver ****7829,"-1,000.00","746,572.60"
,26/04/2022,Transaction,,Online Sale,,Apple Account,-3.47,"746,569.13"
,26/04/2022,Transaction,,Online Sale,,EastX ****2310,-162.49,"746,406.64"
,26/04/2022,Transaction,,Diggory Haddoke,,EastX  Saver ****7829,-579.6,"745,827.04"
,26/04/2022,Transaction,,Online Sale,,Apple Account,-2.51,"745,824.53"
,26/04/2022,Transaction,,Online Sale,,EastX ****2310,-435.29,"745,389.24"
,26/04/2022,Transaction,,Online Sale,,EastX ****2310,-80.65,"745,308.59"
,26/04/2022,Transaction,,Mark Renmant,,EastX  Saver ****7829,-87.12,"745,221.47"
,26/04/2022,Receipt,12345,SHOP SALE,,Sales of Product Income:UK Sales,243,"745,464.47"
,27/04/2022,Receipt,12353,SHOP SALE,,Sales of Product Income:UK Sales,"1,000.00","746,464.47"
,27/04/2022,Receipt,12355,"Calabi, Silvio",,Sales of Product Income:Non UK Sales,200,"746,664.47"
,27/04/2022,Receipt,12354,David Austin,,-Split-,380,"747,044.47"
,27/04/2022,Transaction,,HH Sheikh Mohammed Al-Sharqi,,EastX Bank,"-99,988.00","647,056.47"
,27/04/2022,Transaction,,Dr Eckard Stief,,Apple Account,"-1,050.00","646,006.47"
,27/04/2022,Transaction,,Richard Kilby,,EastX  Saver ****7829,-470,"645,536.47"
,27/04/2022,Transaction,,HH Sheikh Mohammed Al-Sharqi,,Apple Account,-12,"645,524.47"
,28/04/2022,Transaction,,SHOP SALE,,EastX  Saver ****7829,-243,"645,281.47"
,29/04/2022,Receipt,12360,Outdoor Outfitters,,-Split-,100,"645,381.47"
,29/04/2022,Receipt,12357,Online Sale,,Sales of Product Income:Non UK Sales,295.83,"645,677.30"
,29/04/2022,Receipt,12367,West London SS,,Sales of Product Income:UK Sales,94.8,"645,772.10"
,29/04/2022,Receipt,12358,Michael Luke,,-Split-,"1,288.00","647,060.10"
,29/04/2022,Receipt,12365,HH Sheikh Mohammed Al-Sharqi,,Sales of Product Income:Sales,"1,785.00","648,845.10"
,29/04/2022,Receipt,12356,Online Sale,,Sales of Product Income:Non UK Sales,310.83,"649,155.93"
,29/04/2022,Debit Memo,12361,David Austin,,Sales of Product Income:Non UK Sales,-50,"649,105.93"
,29/04/2022,Receipt,12362,SHOP SALE,,Sales of Product Income:UK Sales,99,"649,204.93"
,29/04/2022,Receipt,12366,HH Sheikh Mohammed Al-Sharqi,,Sales of Product Income:Sales,"1,020.00","650,224.93"
,29/04/2022,Transaction,,Online Sale,,Apple Account,-9.21,"650,215.72"
,29/04/2022,Transaction,,David Austin,,-Split-,,"650,215.72"
,29/04/2022,Transaction,,Online Sale,,Apple Account,-4.34,"650,211.38"
,29/04/2022,Receipt,12359,Northwood Group GMBH,,-Split-,132,"650,343.38"
,30/04/2022,Receipt,12352,Armurerie Richard,,-Split-,"7,934.00","658,277.38"
,30/04/2022,Receipt,12364,Online Sale,,Sales of Product Income:UK Sales,22,"658,299.38"
,30/04/2022,Receipt,12373,Laurens  Sliepenbeek,,Orders in Hand/Deferred Income,"11,056.98","669,356.36"
,30/04/2022,Receipt,12363,HH Sheikh Mohammed Al-Sharqi,,-Split-,"61,980.00","731,336.36"
,30/04/2022,Transaction,,Online Sale,,Apple Account,-0.51,"731,335.85"
,30/04/2022,Receipt,12349,Mr R Holden,,-Split-,"81,850.00","813,185.85"
,30/04/2022,Receipt,12351,Armurerie Richard,,-Split-,"5,450.00","818,635.85"
,30/04/2022,Transaction,,Waffen Ortner,,EastX Bank,-510,"818,125.85"
,30/04/2022,Transaction,,Laurens  Sliepenbeek,,EastX Bank,"-11,056.98","807,068.87"
,30/04/2022,Receipt,12348,HH Sheikh Mohammed Al-Sharqi,,Sales of Product Income:Non UK Sales,"32,625.00","839,693.87"
,1/5/2022,Transaction,,Online Sale,,EastX ****2310,-301.62,"839,392.25"
,1/5/2022,Transaction,,"Calabi, Silvio",,EastX  Saver ****7829,-200,"839,192.25"
,1/5/2022,Transaction,,Online Sale,,EastX ****2310,-21.49,"839,170.76"
,1/5/2022,Transaction,,Online Sale,,EastX ****2310,-291.49,"838,879.27"
,4/5/2022,Receipt,12371,Online Sale,,Sales of Product Income:Non UK Sales,131.67,"839,010.94"
,4/5/2022,Transaction,,Online Sale,,Apple Account,-3.05,"839,007.89"
,4/5/2022,Transaction,,Online Sale,,Apple Account,-61.78,"838,946.11"
,4/5/2022,Transaction,,Online Sale,,Apple Account,-4,"838,942.11"
,4/5/2022,Transaction,,Online Sale,,EastX ****2310,-127,"838,815.11"
,4/5/2022,Transaction,,Online Sale,,EastX ****2310,"-2,061.55","836,753.56"
,4/5/2022,Transaction,,Online Sale,,EastX ****2310,-95.28,"836,658.28"
,4/5/2022,Receipt,12369,Online Sale,,Sales of Product Income:Non UK Sales,98.33,"836,756.61"
,4/5/2022,Receipt,12374,Online Sale,,Sales of Product Income:UK Sales,131,"836,887.61"
,4/5/2022,Receipt,12372,Online Sale,,Sales of Product Income:Non UK Sales,340,"837,227.61"
,4/5/2022,Receipt,12368,Online Sale,,Sales of Product Income:UK Sales,241,"837,468.61"
,4/5/2022,Receipt,12370,Online Sale,,Sales of Product Income:Non UK Sales,"2,123.33","839,591.94"
,4/5/2022,Receipt,12375,Northwood Group UK,,Sales of Product Income:Sales,216,"839,807.94"
,4/5/2022,Receipt,12376,Joe Hudson,,-Split-,640,"840,447.94"
,4/5/2022,Transaction,,Online Sale,,Apple Account,-4.96,"840,442.98"
,4/5/2022,Transaction,,Online Sale,,Apple Account,-3.57,"840,439.41"
,4/5/2022,Transaction,,Northwood USA 1,,Apple Account,"-20,929.00","819,510.41"
,4/5/2022,Transaction,,Online Sale,,EastX ****2310,-237.43,"819,272.98"
,4/5/2022,Transaction,,Online Sale,,EastX ****2310,-127.65,"819,145.33"
,4/5/2022,Transaction,,Online Sale,,EastX ****2310,-335.04,"818,810.29"
,4/5/2022,Transaction,,Online Sale,,Apple Account,-4.02,"818,806.27"
,5/5/2022,Receipt,12379,The Traditional English cases Ltd,,Sales of Product Income:UK Sales,288,"819,094.27"
,5/5/2022,Receipt,12380,Online Sale,,Sales of Product Income:Non UK Sales,100,"819,194.27"
,5/5/2022,Receipt,12381,Online Sale,,Sales of Product Income:Non UK Sales,425,"819,619.27"
,5/5/2022,Receipt,12382,Online Sale,,Sales of Product Income:UK Sales,37,"819,656.27"
,5/5/2022,Receipt,12378,HH Sheikh Mohammed Al-Sharqi,,Sales of Product Income:Non UK Sales,"1,200.00","820,856.27"
,5/5/2022,Receipt,12377,David Austin,,-Split-,130,"820,986.27"
,5/5/2022,Transaction,,Online Sale,,Apple Account,-1.6,"820,984.67"
,5/5/2022,Transaction,,Online Sale,,Apple Account,-0.72,"820,983.95"
,5/5/2022,Transaction,,Online Sale,,EastX ****2310,-418.85,"820,565.10"
,5/5/2022,Transaction,,Online Sale,,EastX ****2310,-98.4,"820,466.70"
,5/5/2022,Transaction,,Online Sale,,EastX ****2310,-36.28,"820,430.42"
,5/5/2022,Transaction,,Nelson Neto Junior,,EastX  Saver ****7829,-19.8,"820,410.62"
,5/5/2022,Transaction,,Online Sale,,Apple Account,-6.15,"820,404.47"
,6/5/2022,Receipt,12385,Ross Williamson,,-Split-,85,"820,489.47"
,6/5/2022,Transaction,,Ross Williamson,,EastX  Saver ****7829,-85,"820,404.47"
,6/5/2022,Receipt,12384,Nelson Neto Junior,,Sales of Product Income:UK Sales,19.8,"820,424.27"
,6/5/2022,Receipt,12386,Outdoor Outfitters,,-Split-,850,"821,274.27"
,7/5/2022,Transaction,,Viscount Jonathan Rothermere,,EastX Bank,"-29,100.00","792,174.27"
,8/5/2022,Receipt,12390,Online Sale,,Sales of Product Income:Non UK Sales,105.83,"792,280.10"
,8/5/2022,Receipt,12391,Online Sale,,Sales of Product Income:Non UK Sales,295.83,"792,575.93"
,8/5/2022,Receipt,12387,Mr Roger Karlsson,,Orders in Hand/Deferred Income,"4,500.00","797,075.93"
,8/5/2022,Receipt,12388,Online Sale,,Sales of Product Income:Non UK Sales,250,"797,325.93"
,8/5/2022,Receipt,12389,Online Sale,,Sales of Product Income:Non UK Sales,295.83,"797,621.76"
,8/5/2022,Transaction,,Online Sale,,EastX ****2310,-102.56,"797,519.20"
,8/5/2022,Transaction,,Online Sale,,Apple Account,-4.34,"797,514.86"
,8/5/2022,Transaction,,Online Sale,,EastX ****2310,-291.49,"797,223.37"
,8/5/2022,Transaction,,Online Sale,,Apple Account,-4.34,"797,219.03"
,8/5/2022,Transaction,,Online Sale,,Apple Account,-3.27,"797,215.76"
,8/5/2022,Transaction,,Online Sale,,Apple Account,-3.7,"797,212.06"
,8/5/2022,Transaction,,Online Sale,,EastX ****2310,-291.49,"796,920.57"
,8/5/2022,Transaction,,Online Sale,,EastX ****2310,-246.3,"796,674.27"
,8/5/2022,Transaction,,Mr Roger Karlsson,,EastX Bank,"-4,500.00","792,174.27"
,9/5/2022,Receipt,12392,Online Sale,,Sales of Product Income:Non UK Sales,65,"792,239.27"
,9/5/2022,Transaction,,Online Sale,,Apple Account,-2.09,"792,237.18"
,9/5/2022,Transaction,,Online Sale,,EastX ****2310,-62.91,"792,174.27"
,10/5/2022,Receipt,12393,Online Sale,,Sales of Product Income:Non UK Sales,125,"792,299.27"
,10/5/2022,Transaction,,Online Sale,,Apple Account,-3.83,"792,295.44"
,10/5/2022,Transaction,,Online Sale,,EastX ****2310,-121.17,"792,174.27"
,10/5/2022,Receipt,12394,Adam Kelliher,,-Split-,326,"792,500.27"
,11/5/2022,Receipt,12399,David Modesett,,Orders in Hand/Deferred Income,"60,000.00","852,500.27"
,11/5/2022,Receipt,12397,Online Sale,,Sales of Product Income:UK Sales,61,"852,561.27"
,11/5/2022,Receipt,12398,Corey Knowlton,,Orders in Hand/Deferred Income,"18,000.00","870,561.27"
,11/5/2022,Receipt,12396,Online Sale,,Sales of Product Income:Non UK Sales,141.67,"870,702.94"
,11/5/2022,Transaction,,Online Sale,,Apple Account,-2.18,"870,700.76"
,11/5/2022,Transaction,,Adam Kelliher,,EastX  Saver ****7829,-326,"870,374.76"
,11/5/2022,Transaction,,Online Sale,,EastX ****2310,-59.95,"870,314.81"
,11/5/2022,Transaction,,Online Sale,,EastX ****2310,-139.49,"870,175.32"
,11/5/2022,Transaction,,Online Sale,,Apple Account,-1.05,"870,174.27"
,12/5/2022,Receipt,12400,Sarfaraz Metlo,,-Split-,"3,650.34","873,824.61"
,12/5/2022,Receipt,12401,Online Sale,,Sales of Product Income:Non UK Sales,212.5,"874,037.11"
,12/5/2022,Transaction,,Online Sale,,Apple Account,-3.18,"874,033.93"
,12/5/2022,Transaction,,SHOP SALE,,EastX  Saver ****7829,-60,"873,973.93"
,12/5/2022,Transaction,,Online Sale,,EastX ****2310,-209.32,"873,764.61"
,13/05/2022,Receipt,12403,Brigitte Steinmaßl,,-Split-,195,"873,959.61"
,13/05/2022,Receipt,12402,Online Sale,,Sales of Product Income:Non UK Sales,355,"874,314.61"
,13/05/2022,Transaction,,Online Sale,,Apple Account,-5.17,"874,309.44"
,13/05/2022,Transaction,,Michael Luke,,EastX Bank,"-1,288.00","873,021.44"
,13/05/2022,Transaction,,Online Sale,,EastX ****2310,-349.83,"872,671.61"
,14/05/2022,Receipt,12405,Online Sale,,Sales of Product Income:Non UK Sales,125,"872,796.61"
,14/05/2022,Receipt,12404,Online Sale,,Sales of Product Income:Non UK Sales,310.83,"873,107.44"
,14/05/2022,Receipt,12406,Online Sale,,Sales of Product Income:Non UK Sales,310.83,"873,418.27"
,14/05/2022,Transaction,,Online Sale,,EastX ****2310,-301.62,"873,116.65"
,14/05/2022,Transaction,,Online Sale,,Apple Account,-3.83,"873,112.82"
,14/05/2022,Transaction,,Online Sale,,EastX ****2310,-301.62,"872,811.20"
,14/05/2022,Transaction,,Online Sale,,Apple Account,-9.21,"872,801.99"
,14/05/2022,Transaction,,Online Sale,,EastX ****2310,-121.17,"872,680.82"
,14/05/2022,Transaction,,Online Sale,,Apple Account,-9.21,"872,671.61"
,16/05/2022,Receipt,12407,Online Sale,,Sales of Product Income:Non UK Sales,650,"873,321.61"
,16/05/2022,Receipt,12408,Online Sale,,Sales of Product Income:Non UK Sales,135.83,"873,457.44"
,16/05/2022,Transaction,,David Modesett,,EastX Bank,"-60,000.00","813,457.44"
,16/05/2022,Transaction,,Online Sale,,EastX ****2310,-630.95,"812,826.49"
,16/05/2022,Transaction,,Online Sale,,EastX ****2310,-131.69,"812,694.80"
,16/05/2022,Transaction,,Online Sale,,Apple Account,-4.14,"812,690.66"
,16/05/2022,Transaction,,Online Sale,,Apple Account,-19.05,"812,671.61"
,18/05/2022,Receipt,12414,Mr Marc Newton,,Sales of Product Income:UK Sales,100.32,"812,771.93"
,18/05/2022,Receipt,12413,Sheikh Khalid Bin Abdullah,,-Split-,538,"813,309.93"
,18/05/2022,Receipt,12409,Online Sale,,Sales of Product Income:UK Sales,212,"813,521.93"
,18/05/2022,Receipt,12416,Mr Marc Newton,,Sales of Product Income:UK Sales,0,"813,521.93"
,18/05/2022,Receipt,12410,Online Sale,,Sales of Product Income:Non UK Sales,295.83,"813,817.76"
,18/05/2022,Receipt,12417,The Hon Charles Pearson,,Sales of Product Income:Sales,946.38,"814,764.14"
,18/05/2022,Transaction,,Online Sale,,EastX ****2310,-208.83,"814,555.31"
,18/05/2022,Receipt,12412,Morten Kristoffer Kjus,,-Split-,255,"814,810.31"
,18/05/2022,Receipt,12415,Viscount Jonathan Rothermere,,Sales of Product Income:UK Sales,0,"814,810.31"
,18/05/2022,Receipt,12395,Viscount Jonathan Rothermere,,-Split-,"1,100.00","815,910.31"
,18/05/2022,Transaction,,Online Sale,,EastX ****2310,-291.49,"815,618.82"
,18/05/2022,Transaction,,Online Sale,,Apple Account,-3.17,"815,615.65"
,18/05/2022,Transaction,,Online Sale,,Apple Account,-4.34,"815,611.31"
,18/05/2022,Receipt,12411,Northwood Group UK,,-Split-,148.5,"815,759.81"
,19/05/2022,Receipt,12422,Online Sale,,Sales of Product Income:Non UK Sales,114.17,"815,873.98"
,19/05/2022,Receipt,12420,Northwood Group Kft,,Sales of Product Income:Non UK Sales,650,"816,523.98"
,19/05/2022,Receipt,12419,Armurerie Collard,,Sales of Product Income:Non UK Sales,650,"817,173.98"
,19/05/2022,Receipt,12423,Tamas,,Sales of Product Income:UK Sales,570.65,"817,744.63"
,19/05/2022,Transaction,,Tamas,,EastX  Saver ****7829,-570.65,"817,173.98"
,19/05/2022,Transaction,,Online Sale,,EastX ****2310,-112.37,"817,061.61"
,19/05/2022,Transaction,,Online Sale,,EastX ****2310,-253.2,"816,808.41"
,19/05/2022,Transaction,,Online Sale,,Apple Account,-1.8,"816,806.61"
,19/05/2022,Transaction,,Online Sale,,Apple Account,-3.8,"816,802.81"
,19/05/2022,Receipt,12421,Online Sale,,Sales of Product Income:UK Sales,257,"817,059.81"
,20/05/2022,Receipt,12427,Sidney Hiscox,,-Split-,"2,930.40","819,990.21"
,20/05/2022,Receipt,12426,Online Sale,,Sales of Product Income:Non UK Sales,89.17,"820,079.38"
,20/05/2022,Debit Memo,12428,Sidney Hiscox,,Sales of Product Income:UK Sales,"-2,766.00","817,313.38"
,20/05/2022,Transaction,,Online Sale,,EastX ****2310,-86.38,"817,227.00"
,20/05/2022,Transaction,,Online Sale,,Apple Account,-2.79,"817,224.21"
,20/05/2022,Transaction,,The Hon Charles Pearson,,EastX Bank,-946.38,"816,277.83"
,20/05/2022,Transaction,,Sidney Hiscox,,-Split-,,"816,277.83"
,21/05/2022,Receipt,12431,Online Sale,,Sales of Product Income:Non UK Sales,240,"816,517.83"
,21/05/2022,Receipt,12432,Online Sale,,Sales of Product Income:UK Sales,61,"816,578.83"
,21/05/2022,Receipt,12433,Armurerie Vouzelaud,,Sales of Product Income:Non UK Sales,"9,550.00","826,128.83"
,21/05/2022,Transaction,,Online Sale,,Apple Account,-7.16,"826,121.67"
,21/05/2022,Transaction,,Online Sale,,EastX ****2310,-232.84,"825,888.83"
,21/05/2022,Transaction,,Online Sale,,EastX ****2310,-59.95,"825,828.88"
,21/05/2022,Transaction,,Online Sale,,Apple Account,-1.05,"825,827.83"
,21/05/2022,Transaction,,Morten Kristoffer Kjus,,EastX Bank,-255,"825,572.83"
,24/05/2022,Transaction,,Northwood Group Kft,,EastX Bank,"-7,926.00","817,646.83"
,24/05/2022,Transaction,,Online Sale,,Apple Account,-0.93,"817,645.90"
,24/05/2022,Transaction,,Online Sale,,Apple Account,-2.36,"817,643.54"
,24/05/2022,Transaction,,Online Sale,,EastX ****2310,-315.32,"817,328.22"
,24/05/2022,Receipt,12434,Online Sale,,Sales of Product Income:Non UK Sales,154.17,"817,482.39"
,24/05/2022,Receipt,12436,Online Sale,,Sales of Product Income:Non UK Sales,295.83,"817,778.22"
,24/05/2022,Receipt,12435,Online Sale,,Sales of Product Income:Non UK Sales,320,"818,098.22"
,24/05/2022,Receipt,12442,Glenn Kendall,,Orders in Hand/Deferred Income,"35,000.00","853,098.22"
,24/05/2022,Receipt,12438,Online Sale,,Sales of Product Income:Non UK Sales,540,"853,638.22"
,24/05/2022,Receipt,12440,Online Sale,,Sales of Product Income:UK Sales,52,"853,690.22"
,24/05/2022,Receipt,12439,Online Sale,,Sales of Product Income:Non UK Sales,45.83,"853,736.05"
,24/05/2022,Transaction,,Online Sale,,Apple Account,-4.34,"853,731.71"
,24/05/2022,Receipt,12443,HH Sheikh Mohammed Al-Sharqi,,-Split-,"100,000.00","953,731.71"
,24/05/2022,Receipt,12441,Northwood Group UK,,Sales of Product Income:Sales,162,"953,893.71"
,24/05/2022,Receipt,12437,Online Sale,,Sales of Product Income:Non UK Sales,"1,065.83","954,959.54"
,24/05/2022,Transaction,,Online Sale,,EastX ****2310,"-1,034.72","953,924.82"
,24/05/2022,Transaction,,Online Sale,,EastX ****2310,-44.99,"953,879.83"
,24/05/2022,Transaction,,Online Sale,,EastX ****2310,-532.24,"953,347.59"
,24/05/2022,Transaction,,Online Sale,,Apple Account,-7.76,"953,339.83"
,24/05/2022,Transaction,,Online Sale,,EastX ****2310,-151.81,"953,188.02"
,24/05/2022,Transaction,,Online Sale,,Apple Account,-0.84,"953,187.18"
,24/05/2022,Transaction,,Online Sale,,Apple Account,-4.68,"953,182.50"
,24/05/2022,Transaction,,Online Sale,,Apple Account,-31.11,"953,151.39"
,24/05/2022,Transaction,,Online Sale,,EastX ****2310,-291.49,"952,859.90"
,24/05/2022,Transaction,,Online Sale,,EastX ****2310,-51.07,"952,808.83"
,25/05/2022,Transaction,,Brigitte Steinmaßl,,EastX Bank,-195,"952,613.83"
,25/05/2022,Receipt,12444,David Modesett,,-Split-,"90,000.00","1,042,613.83"
,26/05/2022,Transaction,,HH Sheikh Mohammed Al-Sharqi,,Apple Account,-12,"1,042,601.83"
,26/05/2022,Transaction,,West London SS,,EastX Bank,-94.8,"1,042,507.03"
,26/05/2022,Transaction,,HH Sheikh Mohammed Al-Sharqi,,EastX Bank,"-99,988.00","942,519.03"
,27/05/2022,Transaction,,Online Sale,,Apple Account,-1.47,"942,517.56"
,27/05/2022,Transaction,,Viscount Jonathan Rothermere,,EastX Bank,"-1,100.00","941,417.56"
,27/05/2022,Transaction,,Lee Butler Gun & Rifle Makers,,EastX Bank,-600,"940,817.56"
,27/05/2022,Receipt,12445,SHOP SALE,,Sales of Product Income:UK Sales,0,"940,817.56"
,27/05/2022,Receipt,12447,Vance Daigle,,Sales of Product Income:Non UK Sales,"4,980.00","945,797.56"
,27/05/2022,Receipt,12448,Online Sale,,Sales of Product Income:Non UK Sales,90.83,"945,888.39"
,27/05/2022,Receipt,12446,SHOP SALE,,Sales of Product Income:UK Sales,325,"946,213.39"
,28/05/2022,Transaction,,David Austin,,-Split-,,"946,213.39"
,28/05/2022,Transaction,,Sheikh Salman Bin Ebrahim Al-Khalifa,,-Split-,0,"946,213.39"
,28/05/2022,Debit Memo,12450,Sheikh Salman Bin Ebrahim Al-Khalifa,,-Split-,"-15,315.00","930,898.39"
,28/05/2022,Transaction,,Sheikh Salman Bin Ebrahim Al-Khalifa,,-Split-,,"930,898.39"
,28/05/2022,Receipt,12451,Sheikh Salman Bin Ebrahim Al-Khalifa,,Sales of Product Income:UK Sales,"18,378.00","949,276.39"
,28/05/2022,Receipt,12449,Thomas Hill,,Orders in Hand/Deferred Income,"10,000.00","959,276.39"
,28/05/2022,Transaction,,Sheikh Salman Bin Ebrahim Al-Khalifa,,-Split-,0,"959,276.39"
,28/05/2022,Debit Memo,CN whisky,David Austin,,Sales of Product Income:Non UK Sales,-180,"959,096.39"
,30/05/2022,Receipt,12453,Online Sale,,Sales of Product Income:Non UK Sales,212.5,"959,308.89"
,30/05/2022,Receipt,12452,Online Sale,,Sales of Product Income:Non UK Sales,60.83,"959,369.72"
,30/05/2022,Transaction,,Online Sale,,Apple Account,-1.96,"959,367.76"
,30/05/2022,Transaction,,Online Sale,,Apple Account,-3.18,"959,364.58"
,31/05/2022,Receipt,12461,Vance Daigle,,-Split-,"18,765.00","978,129.58"
,31/05/2022,Receipt,12424,Northwood Group Norway AS,,-Split-,"10,190.80","988,320.38"
,31/05/2022,Receipt,12455,Jillo Waddington,,Sales of Product Income:Sales,"13,000.00","1,001,320.38"
,31/05/2022,Receipt,12429,Armurerie Nouvelle,,Sales of Product Income:Non UK Sales,"29,441.70","1,030,762.08"
,31/05/2022,Receipt,12425,Armurerie Richard,,-Split-,"8,450.00","1,039,212.08"
,31/05/2022,Transaction,,Northwood USA 1,,Apple Account,"-10,694.37","1,028,517.71"
,31/05/2022,Receipt,12350,Armurerie Richard,,-Split-,"11,370.00","1,039,887.71"
,1/6/2022,Receipt,12454,Armurerie Richard,,Sales of Product Income:Non UK Sales,150,"1,040,037.71"
,2/6/2022,Receipt,12458,SHOP SALE,,Sales of Product Income:UK Sales,0,"1,040,037.71"
,2/6/2022,Receipt,12456,Online Sale,,Sales of Product Income:Non UK Sales,244.17,"1,040,281.88"
,2/6/2022,Receipt,12457,Gut Grambow SonySports GmbH,,-Split-,"3,902.00","1,044,183.88"
,2/6/2022,Receipt,12459,SHOP SALE,,-Split-,184.52,"1,044,368.40"
,2/6/2022,Transaction,,Online Sale,,EastX ****2310,-89.36,"1,044,279.04"
,2/6/2022,Transaction,,Sidney Hiscox,,EastX Bank,"-2,930.40","1,041,348.64"
,2/6/2022,Transaction,,Online Sale,,EastX ****2310,-58.87,"1,041,289.77"
,2/6/2022,Transaction,,Sheikh Khalid Bin Abdullah,,EastX  Saver ****7829,-538,"1,040,751.77"
,2/6/2022,Transaction,,SHOP SALE,,EastX  Saver ****7829,-325,"1,040,426.77"
,2/6/2022,Transaction,,Online Sale,,EastX ****2310,-236.89,"1,040,189.88"
,2/6/2022,Transaction,,Online Sale,,Apple Account,-7.28,"1,040,182.60"
,2/6/2022,Transaction,,SHOP SALE,,EastX  Saver ****7829,-184.52,"1,039,998.08"
,3/6/2022,Receipt,12460,Online Sale,,Sales of Product Income:Non UK Sales,100,"1,040,098.08"
,3/6/2022,Transaction,,Online Sale,,EastX ****2310,-98.4,"1,039,999.68"
,3/6/2022,Transaction,,Online Sale,,EastX ****2310,-209.32,"1,039,790.36"
,3/6/2022,Transaction,,Online Sale,,Apple Account,-1.6,"1,039,788.76"
,3/6/2022,Transaction,,Armurerie Vouzelaud,,EastX Bank,"-9,550.00","1,030,238.76"
,3/6/2022,Transaction,,David Modesett,,EastX Bank,"-90,000.00","940,238.76"
,4/6/2022,Receipt,12463,Online Sale,,Sales of Product Income:UK Sales,27,"940,265.76"
,4/6/2022,Transaction,,Online Sale,,Apple Account,-3.92,"940,261.84"
,4/6/2022,Receipt,12462,Online Sale,,Sales of Product Income:UK Sales,260,"940,521.84"
,4/6/2022,Receipt,12465,Online Sale,,Sales of Product Income:Non UK Sales,128.33,"940,650.17"
,4/6/2022,Transaction,,Online Sale,,EastX ****2310,-176.46,"940,473.71"
,4/6/2022,Transaction,,Online Sale,,EastX ****2310,-256.16,"940,217.55"
,4/6/2022,Transaction,,Thomas Hill,,Apple Account,-12,"940,205.55"
,4/6/2022,Transaction,,Online Sale,,EastX ****2310,-124.41,"940,081.14"
,4/6/2022,Transaction,,Online Sale,,Apple Account,-2.71,"940,078.43"
,4/6/2022,Transaction,,Online Sale,,Apple Account,-0.58,"940,077.85"
,4/6/2022,Transaction,,Thomas Hill,,EastX Bank,"-9,988.00","930,089.85"
,4/6/2022,Transaction,,Online Sale,,Apple Account,-3.84,"930,086.01"
,4/6/2022,Transaction,,Online Sale,,EastX ****2310,-26.42,"930,059.59"
,4/6/2022,Transaction,,Don Alberto Bailleres Gonzalez,,EastX Bank,"-12,800.00","917,259.59"
,4/6/2022,Receipt,12464,Online Sale,,Sales of Product Income:Non UK Sales,179.17,"917,438.76"
,5/6/2022,Transaction,,Northwood Group Norway AS,,EastX Bank,"-10,190.80","907,247.96"
,5/6/2022,Transaction,,Stephen Anderson,,EastX Bank,-170,"907,077.96"
,7/6/2022,Receipt,12466,Online Sale,,Sales of Product Income:Non UK Sales,120.83,"907,198.79"
,7/6/2022,Transaction,,Online Sale,,Apple Account,-7.13,"907,191.66"
,7/6/2022,Receipt,12467,Online Sale,,Sales of Product Income:Non UK Sales,420.83,"907,612.49"
,7/6/2022,Receipt,12473,Online Sale,,Sales of Product Income:Non UK Sales,140,"907,752.49"
,7/6/2022,Receipt,12474,Online Sale,,Sales of Product Income:Non UK Sales,249,"908,001.49"
,7/6/2022,Receipt,12471,Online Sale,,Sales of Product Income:Non UK Sales,350,"908,351.49"
,7/6/2022,Receipt,12472,Online Sale,,Sales of Product Income:Non UK Sales,295.83,"908,647.32"
,7/6/2022,Receipt,12469,Online Sale,,Sales of Product Income:Non UK Sales,150,"908,797.32"
,7/6/2022,Receipt,12470,Online Sale,,Sales of Product Income:Non UK Sales,90.83,"908,888.15"
,7/6/2022,Receipt,12468,Online Sale,,Sales of Product Income:Non UK Sales,239,"909,127.15"
,7/6/2022,Transaction,,Online Sale,,Apple Account,-4.26,"909,122.89"
,7/6/2022,Transaction,,Online Sale,,Apple Account,-2.83,"909,120.06"
,7/6/2022,Transaction,,Online Sale,,Apple Account,-4.34,"909,115.72"
,7/6/2022,Transaction,,Online Sale,,EastX ****2310,-339.65,"908,776.07"
,7/6/2022,Transaction,,Online Sale,,EastX ****2310,-135.74,"908,640.33"
,7/6/2022,Transaction,,Online Sale,,Apple Account,-7.42,"908,632.91"
,7/6/2022,Transaction,,Online Sale,,EastX ****2310,-291.49,"908,341.42"
,7/6/2022,Transaction,,Online Sale,,EastX ****2310,-231.87,"908,109.55"
,7/6/2022,Transaction,,Online Sale,,Apple Account,-6.09,"908,103.46"
,7/6/2022,Transaction,,Online Sale,,EastX ****2310,-117.13,"907,986.33"
,7/6/2022,Transaction,,Online Sale,,EastX ****2310,-241.58,"907,744.75"
,7/6/2022,Transaction,,Online Sale,,Apple Account,-3.7,"907,741.05"
,7/6/2022,Transaction,,Armurerie Richard,,-Split-,,"907,741.05"
,7/6/2022,Transaction,,Online Sale,,Apple Account,-10.35,"907,730.70"
,7/6/2022,Transaction,,Online Sale,,EastX ****2310,-147.7,"907,583.00"
,7/6/2022,Transaction,,Online Sale,,EastX ****2310,-248.27,"907,334.73"
,7/6/2022,Debit Memo,12475,Armurerie Richard,,Sales of Product Income:Non UK Sales,"-1,000.00","906,334.73"
,7/6/2022,Transaction,,Online Sale,,EastX ****2310,-414.74,"905,919.99"
,7/6/2022,Transaction,,Online Sale,,EastX ****2310,-88,"905,831.99"
,7/6/2022,Transaction,,Online Sale,,Apple Account,-3.73,"905,828.26"
,7/6/2022,Transaction,,Online Sale,,Apple Account,-2.3,"905,825.96"
,7/6/2022,Receipt,12476,Online Sale,,Sales of Product Income:UK Sales,252,"906,077.96"
,8/6/2022,Receipt,12481,SHOP SALE,,Sales of Product Income:UK Sales,0,"906,077.96"
,8/6/2022,Receipt,12478,Online Sale,,Sales of Product Income:UK Sales,257,"906,334.96"
,8/6/2022,Receipt,12477,Online Sale,,-Split-,27,"906,361.96"
,8/6/2022,Receipt,12480,Davis Peterson,,Sales of Product Income:Non UK Sales,"13,452.50","919,814.46"
,8/6/2022,Receipt,12482,Northwood Group Kft,,-Split-,"1,013.00","920,827.46"
,8/6/2022,Transaction,,Online Sale,,Apple Account,-3.8,"920,823.66"
,8/6/2022,Transaction,,Online Sale,,EastX ****2310,-26.42,"920,797.24"
,8/6/2022,Transaction,,Online Sale,,EastX ****2310,-109.25,"920,687.99"
,8/6/2022,Transaction,,Online Sale,,Apple Account,-1.75,"920,686.24"
,8/6/2022,Transaction,,Online Sale,,EastX ****2310,-253.2,"920,433.04"
,8/6/2022,Transaction,,Online Sale,,Apple Account,-0.58,"920,432.46"
,8/6/2022,Receipt,12479,Online Sale,,Sales of Product Income:UK Sales,111,"920,543.46"
,9/6/2022,Receipt,12493,Braces of Bristol,,-Split-,500,"921,043.46"
,9/6/2022,Receipt,12492,David Austin,,-Split-,305,"921,348.46"
,9/6/2022,Receipt,12489,Declan Morrison,,Orders in Hand/Deferred Income,"6,000.00","927,348.46"
,9/6/2022,Receipt,12484,Online Sale,,-Split-,27,"927,375.46"
,9/6/2022,Receipt,12490,SHOP SALE,,Sales of Product Income:UK Sales,180,"927,555.46"
,9/6/2022,Receipt,12483,Online Sale,,-Split-,27,"927,582.46"
,9/6/2022,Receipt,12488,Carl King,,Orders in Hand/Deferred Income,500,"928,082.46"
,9/6/2022,Receipt,12486,Braces of Bristol,,Sales of Product Income:UK Sales,"11,760.00","939,842.46"
,9/6/2022,Receipt,12487,Online Sale,,Sales of Product Income:Non UK Sales,216.67,"940,059.13"
,9/6/2022,Receipt,12491,David Austin,,-Split-,230,"940,289.13"
,9/6/2022,Receipt,12485,Online Sale,,-Split-,27,"940,316.13"
,9/6/2022,Transaction,,Online Sale,,EastX ****2310,-26.42,"940,289.71"
,9/6/2022,Transaction,,Corey Knowlton,,EastX Bank,"-17,807.07","922,482.64"
,9/6/2022,Transaction,,Online Sale,,EastX ****2310,-213.44,"922,269.20"
,9/6/2022,Transaction,,Online Sale,,EastX ****2310,-26.42,"922,242.78"
,9/6/2022,Transaction,,Online Sale,,Apple Account,-0.58,"922,242.20"
,9/6/2022,Transaction,cash,SHOP SALE,,EastX ****2310,-180,"922,062.20"
,9/6/2022,Transaction,,Joe Hudson,,EastX  Saver ****7829,-640,"921,422.20"
,9/6/2022,Transaction,,Russel Bleiler,,EastX  Saver ****7829,"-1,857.49","919,564.71"
,9/6/2022,Transaction,,Online Sale,,Apple Account,-0.58,"919,564.13"
,9/6/2022,Transaction,,Online Sale,,Apple Account,-0.58,"919,563.55"
,9/6/2022,Transaction,,Online Sale,,EastX ****2310,-26.42,"919,537.13"
,9/6/2022,Transaction,,Online Sale,,Apple Account,-3.23,"919,533.90"
,10/6/2022,Transaction,,Carl King,,EastX Bank,-500,"919,033.90"
,10/6/2022,Transaction,,Braces of Bristol,,EastX Bank,"-4,260.00","914,773.90"
,10/6/2022,Transaction,,Braces of Bristol,,EastX Bank,-500,"914,273.90"
,10/6/2022,Transaction,,Braces of Bristol,,EastX Bank,"-7,500.00","906,773.90"
,11/6/2022,Receipt,12494,Online Sale,,-Split-,386,"907,159.90"
,11/6/2022,Receipt,12496,John C Hayes IV,,-Split-,800.83,"907,960.73"
,11/6/2022,Receipt,12497,Online Sale,,Sales of Product Income:Non UK Sales,54,"908,014.73"
,11/6/2022,Transaction,,Online Sale,,Apple Account,-5.6,"908,009.13"
,11/6/2022,Transaction,,Online Sale,,Apple Account,-0.96,"908,008.17"
,11/6/2022,Transaction,,Online Sale,,EastX ****2310,-380.4,"907,627.77"
,11/6/2022,Transaction,,Online Sale,,EastX ****2310,-53.04,"907,574.73"
,11/6/2022,Receipt,12495,Charles Lesser,,-Split-,357,"907,931.73"
,12/6/2022,Transaction,,Northwood USA 1,,EastX Bank,"-62,933.79","844,997.94"
,15/06/2022,Receipt,12499,Online Sale,,Sales of Product Income:UK Sales,71,"845,068.94"
,15/06/2022,Receipt,12502,HH Sheikh Mohammed Al-Sharqi,,Sales of Product Income:Non UK Sales,"7,000.00","852,068.94"
,15/06/2022,Receipt,12501,Online Sale,,Sales of Product Income:Non UK Sales,240,"852,308.94"
,15/06/2022,Receipt,12503,Stephen Anderson,,Sales of Product Income:Non UK Sales,"2,572.00","854,880.94"
,15/06/2022,Receipt,12498,Online Sale,,Sales of Product Income:Non UK Sales,581.67,"855,462.61"
,15/06/2022,Receipt,12500,Online Sale,,-Split-,27,"855,489.61"
,15/06/2022,Transaction,,Online Sale,,Apple Account,-1.19,"855,488.42"
,15/06/2022,Transaction,,Online Sale,,EastX ****2310,-236.44,"855,251.98"
,15/06/2022,Transaction,,Online Sale,,EastX ****2310,-26.42,"855,225.56"
,15/06/2022,Transaction,,Online Sale,,EastX ****2310,-69.81,"855,155.75"
,15/06/2022,Transaction,,Online Sale,,EastX ****2310,-564.6,"854,591.15"
,15/06/2022,Transaction,,Online Sale,,Apple Account,-17.07,"854,574.08"
,15/06/2022,Transaction,,Online Sale,,Apple Account,-0.58,"854,573.50"
,15/06/2022,Transaction,,Online Sale,,Apple Account,-3.56,"854,569.94"
,16/06/2022,Receipt,12505,Online Sale,,Sales of Product Income:Non UK Sales,108.33,"854,678.27"
,16/06/2022,Receipt,12504,Morten Kristoffer Kjus,,-Split-,350,"855,028.27"
,16/06/2022,Debit Memo,CN12492,David Austin,,-Split-,-305,"854,723.27"
,16/06/2022,Transaction,,David Austin,,-Split-,0,"854,723.27"
,16/06/2022,Transaction,,Online Sale,,Apple Account,-1.72,"854,721.55"
,16/06/2022,Transaction,,Declan Morrison,,EastX Bank,"-6,000.00","848,721.55"
,16/06/2022,Transaction,,Online Sale,,EastX ****2310,-106.61,"848,614.94"
,17/06/2022,Receipt,12514,SHOP SALE,,Sales of Product Income:UK Sales,30,"848,644.94"
,17/06/2022,Transaction,,SHOP SALE,,EastX  Saver ****7829,-17.38,"848,627.56"
,17/06/2022,Receipt,12509,SHOP SALE,,Sales of Product Income:UK Sales,0,"848,627.56"
,17/06/2022,Receipt,12506,Online Sale,,Sales of Product Income:Non UK Sales,55,"848,682.56"
,17/06/2022,Receipt,12510,Online Sale,,Sales of Product Income:UK Sales,61,"848,743.56"
,17/06/2022,Receipt,12507,Online Sale,,Sales of Product Income:UK Sales,197,"848,940.56"
,17/06/2022,Receipt,12508,Balmoral Estate,,Sales of Product Income:UK Sales,0,"848,940.56"
,17/06/2022,Transaction,,Gut Grambow SonySports GmbH,,EastX Bank,"-3,593.00","845,347.56"
,17/06/2022,Transaction,,Online Sale,,Apple Account,-2.96,"845,344.60"
,17/06/2022,Transaction,,Online Sale,,Apple Account,-1.8,"845,342.80"
,17/06/2022,Transaction,,Online Sale,,EastX ****2310,-194.04,"845,148.76"
,17/06/2022,Transaction,,Online Sale,,Apple Account,-1.05,"845,147.71"
,17/06/2022,Transaction,,Online Sale,,EastX ****2310,-59.95,"845,087.76"
,17/06/2022,Transaction,,Online Sale,,EastX ****2310,-53.2,"845,034.56"
,17/06/2022,Transaction,,SHOP SALE,,EastX  Saver ****7829,-30,"845,004.56"
,17/06/2022,Receipt,12515,Nikolai Vladislavovich Gurianov,,-Split-,500,"845,504.56"
,18/06/2022,Receipt,12512,Online Sale,,Sales of Product Income:Non UK Sales,280.83,"845,785.39"
,18/06/2022,Receipt,12511,Online Sale,,Sales of Product Income:Non UK Sales,55,"845,840.39"
,18/06/2022,Receipt,12513,SHOP SALE,,Sales of Product Income:UK Sales,17.38,"845,857.77"
,18/06/2022,Transaction,,Nikolai Vladislavovich Gurianov,,EastX  Saver ****7829,-500,"845,357.77"
,18/06/2022,Transaction,,Online Sale,,Apple Account,-4.13,"845,353.64"
,18/06/2022,Transaction,,John C Hayes IV,,EastX  Saver ****7829,-800.83,"844,552.81"
,18/06/2022,Transaction,,Online Sale,,Apple Account,-1.8,"844,551.01"
,18/06/2022,Transaction,,Davis Peterson,,Apple Account,-12,"844,539.01"
,18/06/2022,Transaction,,Online Sale,,EastX ****2310,-276.7,"844,262.31"
,18/06/2022,Transaction,,Davis Peterson,,EastX Bank,"-14,988.00","829,274.31"
,18/06/2022,Transaction,,Online Sale,,EastX ****2310,-53.2,"829,221.11"
,21/06/2022,Receipt,12521,Online Sale,,Sales of Product Income:UK Sales,257,"829,478.11"
,21/06/2022,Receipt,12519,Northwood Group GMBH,,Sales of Product Income:Non UK Sales,90,"829,568.11"
,21/06/2022,Receipt,12517,Online Sale,,-Split-,27,"829,595.11"
,21/06/2022,Receipt,12520,Davis Peterson,,Sales of Product Income:Non UK Sales,"4,500.00","834,095.11"
,21/06/2022,Receipt,12516,Online Sale,,Sales of Product Income:UK Sales,52,"834,147.11"
,21/06/2022,Receipt,12518,Online Sale,,Sales of Product Income:Non UK Sales,55,"834,202.11"
,21/06/2022,Transaction,,Online Sale,,Apple Account,-3.8,"834,198.31"
,21/06/2022,Transaction,,Online Sale,,EastX ****2310,-253.2,"833,945.11"
,21/06/2022,Transaction,,Online Sale,,Apple Account,-0.58,"833,944.53"
,21/06/2022,Transaction,,Online Sale,,Apple Account,-1.8,"833,942.73"
,21/06/2022,Transaction,,Online Sale,,Apple Account,-0.93,"833,941.80"
,21/06/2022,Transaction,,Online Sale,,EastX ****2310,-51.07,"833,890.73"
,21/06/2022,Transaction,,Online Sale,,EastX ****2310,-53.2,"833,837.53"
,21/06/2022,Transaction,,Online Sale,,EastX ****2310,-26.42,"833,811.11"
,22/06/2022,Transaction,,Morten Kristoffer Kjus,,EastX Bank,-350,"833,461.11"
,23/06/2022,Receipt,12528,Diego Antunes Brito,,-Split-,401.66,"833,862.77"
,23/06/2022,Receipt,12522,SHOP SALE,,Sales of Product Income:UK Sales,0,"833,862.77"
,23/06/2022,Receipt,12524,Online Sale,,Sales of Product Income:Non UK Sales,55,"833,917.77"
,23/06/2022,Receipt,12525,Online Sale,,Sales of Product Income:Non UK Sales,55,"833,972.77"
,23/06/2022,Receipt,12527,Sheikh Salman Bin Ebrahim Al-Khalifa,,Sales of Product Income:Non UK Sales,"3,300.00","837,272.77"
,23/06/2022,Receipt,12523,Online Sale,,Sales of Product Income:UK Sales,37,"837,309.77"
,23/06/2022,Transaction,,Online Sale,,Apple Account,-1.8,"837,307.97"
,23/06/2022,Transaction,,Online Sale,,Apple Account,-1.27,"837,306.70"
,23/06/2022,Transaction,,Online Sale,,EastX ****2310,-53.2,"837,253.50"
,23/06/2022,Transaction,,Online Sale,,Apple Account,-1.8,"837,251.70"
,23/06/2022,Transaction,,Online Sale,,EastX ****2310,-53.2,"837,198.50"
,23/06/2022,Transaction,,Online Sale,,EastX ****2310,-35.73,"837,162.77"
,23/06/2022,Receipt,12526,HH Sheikh Mohammed Al-Sharqi,,-Split-,"6,073.00","843,235.77"
,25/06/2022,Receipt,12529,Online Sale,,Sales of Product Income:Non UK Sales,55,"843,290.77"
,25/06/2022,Receipt,12530,Online Sale,,Sales of Product Income:Non UK Sales,55,"843,345.77"
,25/06/2022,Transaction,,Online Sale,,Apple Account,-1.8,"843,343.97"
,25/06/2022,Transaction,,Online Sale,,Apple Account,-1.8,"843,342.17"
,25/06/2022,Transaction,,Online Sale,,EastX ****2310,-53.2,"843,288.97"
,28/06/2022,Receipt,12537,Giancarlo Lugli,,Sales of Product Income:Non UK Sales,"11,184.00","854,472.97"
,28/06/2022,Receipt,12532,Online Sale,,Sales of Product Income:Non UK Sales,310.83,"854,783.80"
,28/06/2022,Receipt,12534,Mr Roger Karlsson,,Sales of Product Income:UK Sales,"8,338.80","863,122.60"
,28/06/2022,Receipt,12533,Online Sale,,Sales of Product Income:UK Sales,92,"863,214.60"
,28/06/2022,Receipt,12531,Online Sale,,Sales of Product Income:Non UK Sales,175.83,"863,390.43"
,28/06/2022,Receipt,12536,Northwood USA 1,,-Split-,"71,192.00","934,582.43"
,28/06/2022,Transaction,,Simon Barr,,EastX Bank,-570.6,"934,011.83"
,28/06/2022,Transaction,,Online Sale,,EastX ****2310,-173.17,"933,838.66"
,28/06/2022,Transaction,,Vance Daigle,,EastX Bank,"-23,745.00","910,093.66"
,28/06/2022,Transaction,,Online Sale,,Apple Account,-9.21,"910,084.45"
,28/06/2022,Transaction,,Online Sale,,Apple Account,-1.49,"910,082.96"
,28/06/2022,Transaction,,Online Sale,,Apple Account,-2.66,"910,080.30"
,28/06/2022,Receipt,12535,Declan Morrison,,Sales of Product Income:UK Sales,"6,306.00","916,386.30"
,29/06/2022,Receipt,12540,SHOP SALE,,Sales of Product Income:UK Sales,0,"916,386.30"
,29/06/2022,Receipt,12538,Online Sale,,Sales of Product Income:Non UK Sales,55,"916,441.30"
,29/06/2022,Receipt,12539,Online Sale,,Sales of Product Income:Non UK Sales,55,"916,496.30"
,29/06/2022,Transaction,,Online Sale,,EastX ****2310,-53.2,"916,443.10"
,29/06/2022,Transaction,,Online Sale,,Apple Account,-1.8,"916,441.30"
,29/06/2022,Transaction,,Online Sale,,Apple Account,-1.8,"916,439.50"
,29/06/2022,Transaction,,Diego Antunes Brito,,EastX Bank,-420.28,"916,019.22"
,30/06/2022,Receipt,12545,HH Sheikh Mohammed Al-Sharqi:.30-06 London Best S/N 7110,,Orders in Hand/Deferred Income,"15,000.00","931,019.22"
,30/06/2022,Receipt,12541,Online Sale,,-Split-,27,"931,046.22"
,30/06/2022,Receipt,12551,Patrick Slater,,Orders in Hand/Deferred Income,"30,000.00","961,046.22"
,30/06/2022,Receipt,12549,Glenn Kendall,,Orders in Hand/Deferred Income,"10,000.00","971,046.22"
,30/06/2022,Receipt,12546,HH Sheikh Mohammed Al-Sharqi:.600 Hippo CampusX,,Orders in Hand/Deferred Income,"50,000.00","1,021,046.22"
,30/06/2022,Receipt,12547,HH Sheikh Mohammed Al-Sharqi,,Orders in Hand/Deferred Income,"20,000.00","1,041,046.22"
,30/06/2022,Transaction,,Online Sale,,Apple Account,-1.14,"1,041,045.08"
,30/06/2022,Receipt,12544,HH Sheikh Mohammed Al-Sharqi:.223 London  Best S/N 7109,,Orders in Hand/Deferred Income,"15,000.00","1,056,045.08"
,30/06/2022,Transaction,,Online Sale,,Apple Account,-0.58,"1,056,044.50"
,30/06/2022,Transaction,,HH Sheikh Mohammed Al-Sharqi,,Apple Account,-12,"1,056,032.50"
,30/06/2022,Transaction,,Northwood USA 1,,Apple Account,"-5,108.68","1,050,923.82"
,30/06/2022,Transaction,,HH Sheikh Mohammed Al-Sharqi,,EastX Bank,"-99,988.00","950,935.82"
,30/06/2022,Receipt,12542,Online Sale,,Sales of Product Income:UK Sales,67,"951,002.82"
,1/7/2022,Receipt,12553,Online Sale,,Sales of Product Income:Non UK Sales,137.5,"951,140.32"
,1/7/2022,Receipt,12554,Davis Peterson,,Sales of Product Income:Non UK Sales,300,"951,440.32"
,1/7/2022,Receipt,12543,HH Sheikh Mohammed Al-Sharqi:.300 H&H Zebra gun S/N 7101,,Orders in Hand/Deferred Income,"30,000.00","981,440.32"
,1/7/2022,Receipt,12552,Online Sale,,Sales of Product Income:Non UK Sales,55,"981,495.32"
,1/7/2022,Transaction,,Online Sale,,Apple Account,-4.19,"981,491.13"
,1/7/2022,Transaction,,Online Sale,,EastX ****2310,-53.2,"981,437.93"
,1/7/2022,Transaction,,Online Sale,,EastX ****2310,-26.42,"981,411.51"
,1/7/2022,Transaction,,Online Sale,,EastX ****2310,-53.2,"981,358.31"
,1/7/2022,Transaction,,Online Sale,,EastX ****2310,-90.51,"981,267.80"
,1/7/2022,Transaction,,Online Sale,,EastX ****2310,-133.31,"981,134.49"
,1/7/2022,Transaction,,Online Sale,,EastX ****2310,-301.62,"980,832.87"
,1/7/2022,Transaction,,Online Sale,,EastX ****2310,-53.2,"980,779.67"
,1/7/2022,Transaction,,Online Sale,,EastX ****2310,-65.86,"980,713.81"
,1/7/2022,Transaction,,Online Sale,,Apple Account,-1.8,"980,712.01"
,2/7/2022,Receipt,12557,Online Sale,,Sales of Product Income:Non UK Sales,162.5,"980,874.51"
,2/7/2022,Receipt,12558,SHOP SALE,,-Split-,148,"981,022.51"
,2/7/2022,Receipt,12556,Online Sale,,Sales of Product Income:UK Sales,137,"981,159.51"
,2/7/2022,Receipt,12555,SHOP SALE,,Sales of Product Income:UK Sales,0,"981,159.51"
,2/7/2022,Transaction,,Online Sale,,Apple Account,-2.12,"981,157.39"
,2/7/2022,Transaction,,SHOP SALE,,EastX  Saver ****7829,-148,"981,009.39"
,2/7/2022,Transaction,,Online Sale,,Apple Account,-2.48,"981,006.91"
,2/7/2022,Transaction,,Online Sale,,EastX ****2310,-134.88,"980,872.03"
,2/7/2022,Transaction,,Online Sale,,EastX ****2310,-160.02,"980,712.01"
,5/7/2022,Receipt,12561,SHOP SALE,,Sales of Product Income:UK Sales,102,"980,814.01"
,5/7/2022,Receipt,12559,Online Sale,,Sales of Product Income:Non UK Sales,295.83,"981,109.84"
,5/7/2022,Receipt,12560,Christopher J Barber,,Orders in Hand/Deferred Income,"8,805.00","989,914.84"
,5/7/2022,Transaction,,Stephen Anderson,,EastX  Saver ****7829,"-2,742.00","987,172.84"
,5/7/2022,Transaction,,Online Sale,,Apple Account,-4.34,"987,168.50"
,5/7/2022,Transaction,,Christopher J Barber,,EastX Bank,"-8,805.00","978,363.50"
,5/7/2022,Transaction,,SHOP SALE,,EastX  Saver ****7829,-102,"978,261.50"
,5/7/2022,Transaction,,Online Sale,,EastX ****2310,-291.49,"977,970.01"
,7/7/2022,Receipt,12566,Online Sale,,Sales of Product Income:Non UK Sales,55,"978,025.01"
,7/7/2022,Receipt,12578,Mr Roger Karlsson,,Sales of Product Income:UK Sales,0,"978,025.01"
,7/7/2022,Receipt,12564,Online Sale,,Sales of Product Income:Non UK Sales,107.5,"978,132.51"
,7/7/2022,Receipt,12567,Armurerie Nouvelle,,-Split-,312,"978,444.51"
,7/7/2022,Receipt,12565,Online Sale,,-Split-,27,"978,471.51"
,7/7/2022,Transaction,,David Austin,,EastX Bank,"-14,488.00","963,983.51"
,7/7/2022,Transaction,,Online Sale,,Apple Account,-1.71,"963,981.80"
,7/7/2022,Transaction,,David Austin,,Apple Account,-12,"963,969.80"
,7/7/2022,Transaction,,Online Sale,,Apple Account,-1.8,"963,968.00"
,7/7/2022,Transaction,,SHOP SALE,,EastX  Saver ****7829,-92,"963,876.00"
,7/7/2022,Transaction,,Online Sale,,EastX ****2310,-53.2,"963,822.80"
,7/7/2022,Transaction,,Online Sale,,EastX ****2310,-26.42,"963,796.38"
,7/7/2022,Transaction,,Online Sale,,Apple Account,-0.58,"963,795.80"
,7/7/2022,Transaction,,Online Sale,,EastX ****2310,-105.79,"963,690.01"
,9/7/2022,Receipt,12570,Online Sale,,Sales of Product Income:Non UK Sales,55,"963,745.01"
,9/7/2022,Transaction,,Online Sale,,EastX ****2310,-291.49,"963,453.52"
,9/7/2022,Receipt,12575,Online Sale,,Sales of Product Income:UK Sales,130,"963,583.52"
,9/7/2022,Receipt,12574,Online Sale,,Sales of Product Income:UK Sales,197,"963,780.52"
,9/7/2022,Receipt,12571,Online Sale,,Sales of Product Income:Non UK Sales,55,"963,835.52"
,9/7/2022,Receipt,12573,Online Sale,,Sales of Product Income:Non UK Sales,295.83,"964,131.35"
,9/7/2022,Receipt,12572,Online Sale,,Sales of Product Income:Non UK Sales,107.5,"964,238.85"
,9/7/2022,Receipt,12577,SHOP SALE,,Sales of Product Income:UK Sales,92,"964,330.85"
,9/7/2022,Transaction,,Online Sale,,Apple Account,-2.02,"964,328.83"
,9/7/2022,Transaction,,Online Sale,,EastX ****2310,-194.04,"964,134.79"
,9/7/2022,Transaction,,Online Sale,,Apple Account,-1.8,"964,132.99"
,9/7/2022,Transaction,,Online Sale,,Apple Account,-1.71,"964,131.28"
,9/7/2022,Transaction,,Online Sale,,Apple Account,-2.96,"964,128.32"
,9/7/2022,Transaction,,Online Sale,,Apple Account,-3.05,"964,125.27"
,9/7/2022,Transaction,,Online Sale,,Apple Account,-1.8,"964,123.47"
,9/7/2022,Transaction,,SHOP SALE,,EastX  Saver ****7829,-225,"963,898.47"
,9/7/2022,Transaction,,Online Sale,,EastX ****2310,-95.28,"963,803.19"
,9/7/2022,Transaction,,Online Sale,,EastX ****2310,-105.79,"963,697.40"
,9/7/2022,Transaction,,Online Sale,,Apple Account,-4.34,"963,693.06"
,9/7/2022,Transaction,,Online Sale,,EastX ****2310,-127.98,"963,565.08"
,9/7/2022,Transaction,,Online Sale,,EastX ****2310,-53.2,"963,511.88"
,9/7/2022,Transaction,,Online Sale,,EastX ****2310,-53.2,"963,458.68"
,9/7/2022,Receipt,12576,Online Sale,,Sales of Product Income:Non UK Sales,98.33,"963,557.01"
,12/7/2022,Receipt,12579,Mr Roger Karlsson,,-Split-,360,"963,917.01"
,12/7/2022,Receipt,12569,Armurerie Collard,,-Split-,"1,176.00","965,093.01"
,12/7/2022,Transaction,,SHOP SALE,,EastX  Saver ****7829,-99,"964,994.01"
,12/7/2022,Receipt,12580,SHOP SALE,,Sales of Product Income:UK Sales,99,"965,093.01"
,12/7/2022,Receipt,12568,SHOP SALE,,Sales of Product Income:UK Sales,225,"965,318.01"
,13/07/2022,Receipt,12582,Northwood USA 1,,Sales of Product Income:Non UK Sales,"2,243.25","967,561.26"
,13/07/2022,Receipt,12583,Davis Peterson,,-Split-,872,"968,433.26"
,13/07/2022,Transaction,,Armurerie Collard,,EastX Bank,"-7,512.12","960,921.14"
,13/07/2022,Receipt,12581,HH Sheikh Mohammed Al-Sharqi,,Sales of Product Income:Non UK Sales,985.43,"961,906.57"
,13/07/2022,Receipt,12584,The Traditional English cases Ltd,,Sales of Product Income:UK Sales,192.72,"962,099.29"
,14/07/2022,Receipt,12586,Online Sale,,Sales of Product Income:UK Sales,76,"962,175.29"
,14/07/2022,Receipt,12585,Online Sale,,Sales of Product Income:UK Sales,337,"962,512.29"
,14/07/2022,Receipt,12587,SHOP SALE,,Sales of Product Income:UK Sales,0,"962,512.29"
,14/07/2022,Receipt,12588,Online Sale,,Sales of Product Income:Non UK Sales,125,"962,637.29"
,14/07/2022,Transaction,,Online Sale,,EastX ****2310,-332.08,"962,305.21"
,14/07/2022,Transaction,,Online Sale,,EastX ****2310,-123.05,"962,182.16"
,14/07/2022,Transaction,,Online Sale,,Apple Account,-1.95,"962,180.21"
,14/07/2022,Transaction,,Jillo Waddington,,EastX Bank,"-10,000.00","952,180.21"
,14/07/2022,Transaction,,Online Sale,,Apple Account,-1.26,"952,178.95"
,14/07/2022,Transaction,,Online Sale,,Apple Account,-4.92,"952,174.03"
,14/07/2022,Transaction,,Online Sale,,EastX ****2310,-74.74,"952,099.29"
,18/07/2022,Transaction,,Jillo Waddington,,EastX Bank,"-3,000.00","949,099.29"
,20/07/2022,Receipt,12590,Online Sale,,Sales of Product Income:Non UK Sales,310.83,"949,410.12"
,20/07/2022,Transaction,,Online Sale,,Apple Account,-4.02,"949,406.10"
,20/07/2022,Receipt,12598,Online Sale,,Sales of Product Income:Non UK Sales,272.5,"949,678.60"
,20/07/2022,Receipt,12599,Online Sale,,Sales of Product Income:Non UK Sales,650,"950,328.60"
,20/07/2022,Receipt,12592,Online Sale,,Sales of Product Income:Non UK Sales,241.67,"950,570.27"
,20/07/2022,Receipt,12600,Online Sale,,Sales of Product Income:UK Sales,71,"950,641.27"
,20/07/2022,Receipt,12595,Online Sale,,Sales of Product Income:Non UK Sales,231.67,"950,872.94"
,20/07/2022,Receipt,12591,Online Sale,,Sales of Product Income:Non UK Sales,"1,550.00","952,422.94"
,20/07/2022,Receipt,12596,Online Sale,,Sales of Product Income:Non UK Sales,224,"952,646.94"
,20/07/2022,Receipt,12589,Online Sale,,Sales of Product Income:Non UK Sales,245.83,"952,892.77"
,20/07/2022,Receipt,12593,Online Sale,,Sales of Product Income:Non UK Sales,195,"953,087.77"
,20/07/2022,Receipt,12597,Online Sale,,Sales of Product Income:UK Sales,82,"953,169.77"
,20/07/2022,Transaction,,Online Sale,,Apple Account,-1.35,"953,168.42"
,20/07/2022,Transaction,,Online Sale,,Apple Account,-1.19,"953,167.23"
,20/07/2022,Transaction,,Online Sale,,Apple Account,-6.92,"953,160.31"
,20/07/2022,Transaction,,Online Sale,,EastX ****2310,-192.07,"952,968.24"
,20/07/2022,Transaction,,Online Sale,,Apple Account,-2.93,"952,965.31"
,20/07/2022,Transaction,,Online Sale,,EastX ****2310,-234.46,"952,730.85"
,20/07/2022,Transaction,,Online Sale,,EastX ****2310,-224.75,"952,506.10"
,20/07/2022,Transaction,,Online Sale,,EastX ****2310,-301.62,"952,204.48"
,20/07/2022,Transaction,,Online Sale,,EastX ****2310,-242.19,"951,962.29"
,20/07/2022,Transaction,,Online Sale,,Apple Account,-3.64,"951,958.65"
,20/07/2022,Transaction,,Online Sale,,Apple Account,-9.3,"951,949.35"
,20/07/2022,Transaction,,Online Sale,,EastX ****2310,-268.48,"951,680.87"
,20/07/2022,Transaction,,Online Sale,,Apple Account,-9.21,"951,671.66"
,20/07/2022,Transaction,,Online Sale,,EastX ****2310,-220.66,"951,451.00"
,20/07/2022,Transaction,,Online Sale,,Apple Account,-45.15,"951,405.85"
,20/07/2022,Transaction,,Online Sale,,EastX ****2310,-640.7,"950,765.15"
,20/07/2022,Transaction,,Online Sale,,EastX ****2310,"-1,504.85","949,260.30"
,20/07/2022,Transaction,,Online Sale,,Apple Account,-7.21,"949,253.09"
,20/07/2022,Transaction,,Online Sale,,EastX ****2310,-213.44,"949,039.65"
,20/07/2022,Transaction,,Online Sale,,Apple Account,-3.23,"949,036.42"
,20/07/2022,Transaction,,Online Sale,,EastX ****2310,-69.81,"948,966.61"
,20/07/2022,Transaction,,Online Sale,,EastX ****2310,-80.65,"948,885.96"
,20/07/2022,Transaction,,Online Sale,,Apple Account,-3.34,"948,882.62"
,20/07/2022,Receipt,12594,Online Sale,,Sales of Product Income:Non UK Sales,216.67,"949,099.29"
,21/07/2022,Receipt,12605,Sheikh Salman Bin Ebrahim Al-Khalifa,,Sales of Product Income:Non UK Sales,"5,932.15","955,031.44"
,21/07/2022,Receipt,12604,Northwood Group Norway AS,,Sales of Product Income:Non UK Sales,858,"955,889.44"
,21/07/2022,Receipt,12603,Russel Bleiler,,Sales of Product Income:Non UK Sales,240,"956,129.44"
,21/07/2022,Transaction,,David Austin,,EastX Bank,"-14,500.00","941,629.44"
,21/07/2022,Receipt,12602,SHOP SALE,,Sales of Product Income:Non UK Sales,0,"941,629.44"
,21/07/2022,Receipt,12601,SHOP SALE,,Sales of Product Income:UK Sales,0,"941,629.44"
,21/07/2022,Receipt,12606,Sheikh Khalid Bin Ibrahim Al-Khalifa,,Sales of Product Income:Non UK Sales,"1,078.00","942,707.44"
,22/07/2022,Receipt,12609,Russell Gordy,,Orders in Hand/Deferred Income,"75,000.00","1,017,707.44"
,22/07/2022,Receipt,12607,Online Sale,,Sales of Product Income:Non UK Sales,51.67,"1,017,759.11"
,22/07/2022,Transaction,,Online Sale,,Apple Account,-0.92,"1,017,758.19"
,22/07/2022,Transaction,,Online Sale,,EastX ****2310,-50.75,"1,017,707.44"
,22/07/2022,Transaction,,Armurerie Nouvelle,,EastX Bank,-312,"1,017,395.44"
,22/07/2022,Receipt,12610,Armurerie Richard,,Sales of Product Income:Non UK Sales,"1,420.00","1,018,815.44"
,23/07/2022,Receipt,12611,Online Sale,,Sales of Product Income:Non UK Sales,"2,530.00","1,021,345.44"
,23/07/2022,Transaction,,Online Sale,,EastX ****2310,"-2,456.43","1,018,889.01"
,23/07/2022,Transaction,,Online Sale,,Apple Account,-73.57,"1,018,815.44"
,26/07/2022,Receipt,12716,SHOP SALE,,Sales of Product Income:UK Sales,245,"1,019,060.44"
,26/07/2022,Receipt,12700,SHOP SALE,,-Split-,160,"1,019,220.44"
,26/07/2022,Receipt,12682,SHOP SALE,,Sales of Product Income:UK Sales,25,"1,019,245.44"
,26/07/2022,Receipt,12612,Online Sale,,Sales of Product Income:UK Sales,71,"1,019,316.44"
,26/07/2022,Receipt,12665,SHOP SALE,,Sales of Product Income:UK Sales,25,"1,019,341.44"
,26/07/2022,Receipt,12713,SHOP SALE,,Sales of Product Income:UK Sales,119,"1,019,460.44"
,26/07/2022,Receipt,12654,SHOP SALE,,Sales of Product Income:UK Sales,119,"1,019,579.44"
,26/07/2022,Receipt,12689,SHOP SALE,,Sales of Product Income:UK Sales,49,"1,019,628.44"
,26/07/2022,Receipt,12658,SHOP SALE,,Sales of Product Income:UK Sales,119,"1,019,747.44"
,26/07/2022,Receipt,12643,SHOP SALE,,Sales of Product Income:UK Sales,59,"1,019,806.44"
,26/07/2022,Receipt,12699,SHOP SALE,,Sales of Product Income:UK Sales,90,"1,019,896.44"
,26/07/2022,Receipt,12698,SHOP SALE,,-Split-,104,"1,020,000.44"
,26/07/2022,Receipt,12685,SHOP SALE,,Sales of Product Income:UK Sales,25,"1,020,025.44"
,26/07/2022,Receipt,12697,SHOP SALE,,Sales of Product Income:UK Sales,100,"1,020,125.44"
,26/07/2022,Receipt,12634,SHOP SALE,,Sales of Product Income:UK Sales,25,"1,020,150.44"
,26/07/2022,Receipt,12646,SHOP SALE,,Sales of Product Income:UK Sales,99,"1,020,249.44"
,26/07/2022,Receipt,12644,SHOP SALE,,Sales of Product Income:UK Sales,85,"1,020,334.44"
,26/07/2022,Receipt,12704,SHOP SALE,,Sales of Product Income:UK Sales,245,"1,020,579.44"
,26/07/2022,Receipt,12721,Hartmann & Weiss GmbH,,Sales of Product Income:Non UK Sales,529.65,"1,021,109.09"
,26/07/2022,Receipt,12705,SHOP SALE,,Sales of Product Income:UK Sales,59,"1,021,168.09"
,26/07/2022,Receipt,12626,SHOP SALE,,Sales of Product Income:UK Sales,59,"1,021,227.09"
,26/07/2022,Receipt,12636,SHOP SALE,,Sales of Product Income:UK Sales,59,"1,021,286.09"
,26/07/2022,Receipt,12632,SHOP SALE,,Sales of Product Income:UK Sales,25,"1,021,311.09"
,26/07/2022,Receipt,12650,SHOP SALE,,Sales of Product Income:UK Sales,57,"1,021,368.09"
,26/07/2022,Receipt,12637,SHOP SALE,,Sales of Product Income:UK Sales,10,"1,021,378.09"
,26/07/2022,Receipt,12718,SHOP SALE,,Sales of Product Income:UK Sales,0,"1,021,378.09"
,26/07/2022,Receipt,12622,SHOP SALE,,-Split-,64,"1,021,442.09"
,26/07/2022,Receipt,12668,SHOP SALE,,Sales of Product Income:UK Sales,25,"1,021,467.09"
,26/07/2022,Receipt,12679,SHOP SALE,,Sales of Product Income:UK Sales,87,"1,021,554.09"
,26/07/2022,Receipt,12671,SHOP SALE,,Sales of Product Income:UK Sales,25,"1,021,579.09"
,26/07/2022,Receipt,12642,SHOP SALE,,Sales of Product Income:UK Sales,57,"1,021,636.09"
,26/07/2022,Receipt,12706,SHOP SALE,,Sales of Product Income:UK Sales,150,"1,021,786.09"
,26/07/2022,Receipt,12616,Online Sale,,Sales of Product Income:UK Sales,37,"1,021,823.09"
,26/07/2022,Receipt,12614,Online Sale,,Sales of Product Income:Non UK Sales,256.67,"1,022,079.76"
,26/07/2022,Receipt,12683,SHOP SALE,,Sales of Product Income:UK Sales,295,"1,022,374.76"
,26/07/2022,Receipt,12667,SHOP SALE,,Sales of Product Income:UK Sales,245,"1,022,619.76"
,26/07/2022,Receipt,12620,SHOP SALE,,Sales of Product Income:UK Sales,245,"1,022,864.76"
,26/07/2022,Receipt,12653,SHOP SALE,,-Split-,138,"1,023,002.76"
,26/07/2022,Receipt,12633,SHOP SALE,,-Split-,40,"1,023,042.76"
,26/07/2022,Receipt,12707,SHOP SALE,,-Split-,20,"1,023,062.76"
,26/07/2022,Receipt,12691,SHOP SALE,,-Split-,73,"1,023,135.76"
,26/07/2022,Receipt,12678,SHOP SALE,,Sales of Product Income:UK Sales,59,"1,023,194.76"
,26/07/2022,Receipt,12664,SHOP SALE,,Sales of Product Income:UK Sales,50,"1,023,244.76"
,26/07/2022,Receipt,12662,SHOP SALE,,-Split-,469,"1,023,713.76"
,26/07/2022,Receipt,12629,SHOP SALE,,Sales of Product Income:UK Sales,299,"1,024,012.76"
,26/07/2022,Receipt,12656,SHOP SALE,,Sales of Product Income:UK Sales,119,"1,024,131.76"
,26/07/2022,Receipt,12615,Online Sale,,Sales of Product Income:UK Sales,131,"1,024,262.76"
,26/07/2022,Receipt,12710,SHOP SALE,,Sales of Product Income:UK Sales,176.4,"1,024,439.16"
,26/07/2022,Receipt,12645,SHOP SALE,,Sales of Product Income:UK Sales,15,"1,024,454.16"
,26/07/2022,Receipt,12639,SHOP SALE,,Sales of Product Income:UK Sales,199,"1,024,653.16"
,26/07/2022,Receipt,12638,SHOP SALE,,Sales of Product Income:UK Sales,25,"1,024,678.16"
,26/07/2022,Receipt,12651,SHOP SALE,,Sales of Product Income:UK Sales,48,"1,024,726.16"
,26/07/2022,Receipt,12694,SHOP SALE,,Sales of Product Income:UK Sales,57,"1,024,783.16"
,26/07/2022,Receipt,12657,SHOP SALE,,Sales of Product Income:UK Sales,25,"1,024,808.16"
,26/07/2022,Receipt,12641,SHOP SALE,,-Split-,460,"1,025,268.16"
,26/07/2022,Receipt,12640,SHOP SALE,,Sales of Product Income:UK Sales,25,"1,025,293.16"
,26/07/2022,Receipt,12715,SHOP SALE,,-Split-,168,"1,025,461.16"
,26/07/2022,Receipt,12663,SHOP SALE,,Sales of Product Income:Non UK Sales,40,"1,025,501.16"
,26/07/2022,Receipt,12675,SHOP SALE,,Sales of Product Income:UK Sales,150,"1,025,651.16"
,26/07/2022,Receipt,12627,SHOP SALE,,Sales of Product Income:UK Sales,25,"1,025,676.16"
,26/07/2022,Receipt,12613,Online Sale,,Sales of Product Income:UK Sales,222,"1,025,898.16"
,26/07/2022,Receipt,12676,SHOP SALE,,Sales of Product Income:UK Sales,180,"1,026,078.16"
,26/07/2022,Receipt,12692,SHOP SALE,,Sales of Product Income:UK Sales,25,"1,026,103.16"
,26/07/2022,Receipt,12690,SHOP SALE,,Sales of Product Income:UK Sales,99,"1,026,202.16"
,26/07/2022,Receipt,12677,SHOP SALE,,-Split-,98,"1,026,300.16"
,26/07/2022,Receipt,12674,SHOP SALE,,Sales of Product Income:UK Sales,57,"1,026,357.16"
,26/07/2022,Receipt,12670,SHOP SALE,,Sales of Product Income:UK Sales,99,"1,026,456.16"
,26/07/2022,Receipt,12714,SHOP SALE,,-Split-,129,"1,026,585.16"
,26/07/2022,Receipt,12649,SHOP SALE,,-Split-,74,"1,026,659.16"
,26/07/2022,Receipt,12625,SHOP SALE,,Sales of Product Income:UK Sales,25,"1,026,684.16"
,26/07/2022,Receipt,12623,SHOP SALE,,Sales of Product Income:UK Sales,25,"1,026,709.16"
,26/07/2022,Receipt,12709,SHOP SALE,,-Split-,124,"1,026,833.16"
,26/07/2022,Receipt,12703,SHOP SALE,,Sales of Product Income:UK Sales,15,"1,026,848.16"
,26/07/2022,Receipt,12672,SHOP SALE,,Sales of Product Income:UK Sales,57,"1,026,905.16"
,26/07/2022,Receipt,12619,SHOP SALE,,Sales of Product Income:UK Sales,49,"1,026,954.16"
,26/07/2022,Receipt,12711,SHOP SALE,,Sales of Product Income:UK Sales,57,"1,027,011.16"
,26/07/2022,Receipt,12684,SHOP SALE,,Sales of Product Income:UK Sales,15,"1,027,026.16"
,26/07/2022,Receipt,12708,SHOP SALE,,-Split-,324,"1,027,350.16"
,26/07/2022,Receipt,12661,SHOP SALE,,Sales of Product Income:UK Sales,99,"1,027,449.16"
,26/07/2022,Receipt,12660,SHOP SALE,,Sales of Product Income:UK Sales,25,"1,027,474.16"
,26/07/2022,Receipt,12701,SHOP SALE,,Sales of Product Income:UK Sales,20,"1,027,494.16"
,26/07/2022,Receipt,12647,SHOP SALE,,Sales of Product Income:UK Sales,25,"1,027,519.16"
,26/07/2022,Receipt,12631,SHOP SALE,,Sales of Product Income:UK Sales,59,"1,027,578.16"
,26/07/2022,Receipt,12669,SHOP SALE,,Sales of Product Income:UK Sales,49,"1,027,627.16"
,26/07/2022,Receipt,12630,SHOP SALE,,Sales of Product Income:UK Sales,49,"1,027,676.16"
,26/07/2022,Receipt,12618,SHOP SALE,,Sales of Product Income:UK Sales,59,"1,027,735.16"
,26/07/2022,Receipt,12659,SHOP SALE,,Sales of Product Income:UK Sales,20,"1,027,755.16"
,26/07/2022,Receipt,12719,Matthias Draxler,,-Split-,84,"1,027,839.16"
,26/07/2022,Receipt,12635,SHOP SALE,,Sales of Product Income:UK Sales,25,"1,027,864.16"
,26/07/2022,Receipt,12712,SHOP SALE,,Sales of Product Income:UK Sales,99,"1,027,963.16"
,26/07/2022,Receipt,12688,SHOP SALE,,Sales of Product Income:UK Sales,50,"1,028,013.16"
,26/07/2022,Receipt,12695,SHOP SALE,,Sales of Product Income:UK Sales,99,"1,028,112.16"
,26/07/2022,Receipt,12648,SHOP SALE,,-Split-,74,"1,028,186.16"
,26/07/2022,Receipt,12686,SHOP SALE,,Sales of Product Income:UK Sales,50,"1,028,236.16"
,26/07/2022,Receipt,12666,SHOP SALE,,-Split-,82,"1,028,318.16"
,26/07/2022,Receipt,12687,SHOP SALE,,Sales of Product Income:UK Sales,120,"1,028,438.16"
,26/07/2022,Receipt,12680,SHOP SALE,,Sales of Product Income:UK Sales,9,"1,028,447.16"
,26/07/2022,Receipt,12621,SHOP SALE,,Sales of Product Income:UK Sales,299,"1,028,746.16"
,26/07/2022,Receipt,12717,SHOP SALE,,-Split-,65,"1,028,811.16"
,26/07/2022,Receipt,12673,SHOP SALE,,Sales of Product Income:UK Sales,25,"1,028,836.16"
,26/07/2022,Receipt,12681,SHOP SALE,,-Split-,132,"1,028,968.16"
,26/07/2022,Receipt,12628,SHOP SALE,,Sales of Product Income:UK Sales,49,"1,029,017.16"
,26/07/2022,Receipt,12720,Jung Jagd Sportwaffen,,-Split-,105,"1,029,122.16"
,26/07/2022,Receipt,12655,SHOP SALE,,Sales of Product Income:UK Sales,25,"1,029,147.16"
,26/07/2022,Receipt,12617,SHOP SALE,,Sales of Product Income:UK Sales,25,"1,029,172.16"
,26/07/2022,Receipt,12693,SHOP SALE,,-Split-,124,"1,029,296.16"
,26/07/2022,Receipt,12624,SHOP SALE,,Sales of Product Income:UK Sales,99,"1,029,395.16"
,26/07/2022,Receipt,12696,SHOP SALE,,Sales of Product Income:UK Sales,199,"1,029,594.16"
,26/07/2022,Receipt,12652,SHOP SALE,,Sales of Product Income:UK Sales,57,"1,029,651.16"
,26/07/2022,Receipt,12702,SHOP SALE,,-Split-,104,"1,029,755.16"
,26/07/2022,Transaction,,SHOP SALE,,EastX ****2310,-115.73,"1,029,639.43"
,26/07/2022,Transaction,,SHOP SALE,,EastX ****2310,-55.43,"1,029,584.00"
,26/07/2022,Transaction,,SHOP SALE,,Apple Account,-6.74,"1,029,577.26"
,26/07/2022,Transaction,,SHOP SALE,,EastX ****2310,-24.31,"1,029,552.95"
,26/07/2022,Transaction,,SHOP SALE,,EastX ****2310,-238.26,"1,029,314.69"
,26/07/2022,Transaction,,SHOP SALE,,Apple Account,-8.11,"1,029,306.58"
,26/07/2022,Transaction,,SHOP SALE,,Apple Account,-5.47,"1,029,301.11"
,26/07/2022,Transaction,,SHOP SALE,,Apple Account,-2.86,"1,029,298.25"
,26/07/2022,Transaction,,SHOP SALE,,EastX ****2310,-79.74,"1,029,218.51"
,26/07/2022,Transaction,,SHOP SALE,,EastX ****2310,-24.31,"1,029,194.20"
,26/07/2022,Transaction,,SHOP SALE,,EastX ****2310,-101.14,"1,029,093.06"
,26/07/2022,Transaction,,SHOP SALE,,EastX ****2310,-24.31,"1,029,068.75"
,26/07/2022,Transaction,,SHOP SALE,,EastX ****2310,-62.24,"1,029,006.51"
,26/07/2022,Transaction,,SHOP SALE,,Apple Account,-12.9,"1,028,993.61"
,26/07/2022,Transaction,,SHOP SALE,,Apple Account,-0.69,"1,028,992.92"
,26/07/2022,Transaction,,SHOP SALE,,EastX ****2310,-46.68,"1,028,946.24"
,26/07/2022,Transaction,,SHOP SALE,,Apple Account,-1.32,"1,028,944.92"
,26/07/2022,Transaction,,SHOP SALE,,Apple Account,-4.95,"1,028,939.97"
,26/07/2022,Transaction,,SHOP SALE,,Apple Account,-12.65,"1,028,927.32"
,26/07/2022,Transaction,,SHOP SALE,,Apple Account,-0.69,"1,028,926.63"
,26/07/2022,Transaction,,SHOP SALE,,EastX ****2310,-290.78,"1,028,635.85"
,26/07/2022,Transaction,,SHOP SALE,,EastX ****2310,-55.43,"1,028,580.42"
,26/07/2022,Transaction,,SHOP SALE,,EastX ****2310,-57.38,"1,028,523.04"
,26/07/2022,Transaction,,Online Sale,,Apple Account,-2.03,"1,028,521.01"
,26/07/2022,Transaction,,SHOP SALE,,EastX ****2310,-19.45,"1,028,501.56"
,26/07/2022,Transaction,,SHOP SALE,,Apple Account,-0.69,"1,028,500.87"
,26/07/2022,Transaction,,SHOP SALE,,EastX ****2310,-57.38,"1,028,443.49"
,26/07/2022,Transaction,,SHOP SALE,,EastX ****2310,-24.31,"1,028,419.18"
,26/07/2022,Transaction,,SHOP SALE,,Apple Account,-1.57,"1,028,417.61"
,26/07/2022,Transaction,,SHOP SALE,,EastX ****2310,-71.96,"1,028,345.65"
,26/07/2022,Transaction,,SHOP SALE,,Apple Account,-1.62,"1,028,344.03"
,26/07/2022,Transaction,,SHOP SALE,,EastX ****2310,-57.38,"1,028,286.65"
,26/07/2022,Transaction,,SHOP SALE,,Apple Account,-1.35,"1,028,285.30"
,26/07/2022,Transaction,,SHOP SALE,,Apple Account,-0.69,"1,028,284.61"
,26/07/2022,Transaction,,Online Sale,,EastX ****2310,-249.03,"1,028,035.58"
,26/07/2022,Transaction,,SHOP SALE,,Apple Account,-0.41,"1,028,035.17"
,26/07/2022,Transaction,,SHOP SALE,,Apple Account,-2.72,"1,028,032.45"
,26/07/2022,Transaction,,SHOP SALE,,EastX ****2310,-24.31,"1,028,008.14"
,26/07/2022,Transaction,,SHOP SALE,,Apple Account,-2.7,"1,028,005.44"
,26/07/2022,Transaction,,SHOP SALE,,Apple Account,-8.91,"1,027,996.53"
,26/07/2022,Transaction,,SHOP SALE,,EastX ****2310,-128.37,"1,027,868.16"
,26/07/2022,Transaction,,SHOP SALE,,Apple Account,-0.69,"1,027,867.47"
,26/07/2022,Transaction,,SHOP SALE,,EastX ****2310,-47.65,"1,027,819.82"
,26/07/2022,Transaction,,SHOP SALE,,Apple Account,-2.72,"1,027,817.10"
,26/07/2022,Transaction,,SHOP SALE,,EastX ****2310,-55.43,"1,027,761.67"
,26/07/2022,Transaction,,SHOP SALE,,Apple Account,-3.27,"1,027,758.40"
,26/07/2022,Transaction,,SHOP SALE,,EastX ****2310,-55.43,"1,027,702.97"
,26/07/2022,Transaction,,SHOP SALE,,EastX ****2310,-238.26,"1,027,464.71"
,26/07/2022,Transaction,,SHOP SALE,,EastX ****2310,-57.38,"1,027,407.33"
,26/07/2022,Transaction,,SHOP SALE,,Apple Account,-1.62,"1,027,405.71"
,26/07/2022,Transaction,,SHOP SALE,,Apple Account,-0.69,"1,027,405.02"
,26/07/2022,Transaction,,SHOP SALE,,EastX ****2310,-290.78,"1,027,114.24"
,26/07/2022,Transaction,,SHOP SALE,,EastX ****2310,-24.31,"1,027,089.93"
,26/07/2022,Transaction,,SHOP SALE,,Apple Account,-0.28,"1,027,089.65"
,26/07/2022,Transaction,,Online Sale,,EastX ****2310,-36.28,"1,027,053.37"
,26/07/2022,Transaction,,SHOP SALE,,Apple Account,-0.25,"1,027,053.12"
,26/07/2022,Transaction,,SHOP SALE,,Apple Account,-0.69,"1,027,052.43"
,26/07/2022,Transaction,,SHOP SALE,,Apple Account,-4.62,"1,027,047.81"
,26/07/2022,Transaction,,SHOP SALE,,Apple Account,-3.3,"1,027,044.51"
,26/07/2022,Transaction,,SHOP SALE,,Apple Account,-1.57,"1,027,042.94"
,26/07/2022,Transaction,,SHOP SALE,,Apple Account,-4.4,"1,027,038.54"
,26/07/2022,Transaction,,SHOP SALE,,EastX ****2310,-155.6,"1,026,882.94"
,26/07/2022,Transaction,,SHOP SALE,,EastX ****2310,-96.28,"1,026,786.66"
,26/07/2022,Transaction,,SHOP SALE,,Apple Account,-1.57,"1,026,785.09"
,26/07/2022,Transaction,,SHOP SALE,,EastX ****2310,-96.28,"1,026,688.81"
,26/07/2022,Transaction,,SHOP SALE,,Apple Account,-1.76,"1,026,687.05"
,26/07/2022,Transaction,,SHOP SALE,,Apple Account,-8.22,"1,026,678.83"
,26/07/2022,Transaction,,SHOP SALE,,EastX ****2310,-87.52,"1,026,591.31"
,26/07/2022,Transaction,,SHOP SALE,,EastX ****2310,-286.89,"1,026,304.42"
,26/07/2022,Transaction,,SHOP SALE,,EastX ****2310,-82.66,"1,026,221.76"
,26/07/2022,Transaction,,SHOP SALE,,EastX ****2310,-193.53,"1,026,028.23"
,26/07/2022,Transaction,,SHOP SALE,,Apple Account,-1.62,"1,026,026.61"
,26/07/2022,Transaction,,SHOP SALE,,EastX ****2310,-120.59,"1,025,906.02"
,26/07/2022,Transaction,,SHOP SALE,,EastX ****2310,-145.86,"1,025,760.16"
,26/07/2022,Transaction,,SHOP SALE,,Apple Account,-1.62,"1,025,758.54"
,26/07/2022,Transaction,,SHOP SALE,,Apple Account,-1.35,"1,025,757.19"
,26/07/2022,Transaction,,SHOP SALE,,Apple Account,-2.72,"1,025,754.47"
,26/07/2022,Transaction,,SHOP SALE,,EastX ****2310,-447.35,"1,025,307.12"
,26/07/2022,Transaction,,SHOP SALE,,Apple Account,-0.69,"1,025,306.43"
,26/07/2022,Transaction,,Armurerie Nouvelle,,EastX Bank,-900,"1,024,406.43"
,26/07/2022,Transaction,,SHOP SALE,,Apple Account,-2.04,"1,024,404.39"
,26/07/2022,Transaction,,SHOP SALE,,EastX ****2310,-84.61,"1,024,319.78"
,26/07/2022,Transaction,,SHOP SALE,,EastX ****2310,-63.21,"1,024,256.57"
,26/07/2022,Transaction,,SHOP SALE,,Apple Account,-4.14,"1,024,252.43"
,26/07/2022,Transaction,,SHOP SALE,,Apple Account,-0.69,"1,024,251.74"
,26/07/2022,Transaction,,SHOP SALE,,Apple Account,-1.35,"1,024,250.39"
,26/07/2022,Transaction,,SHOP SALE,,Apple Account,-2.72,"1,024,247.67"
,26/07/2022,Transaction,,Online Sale,,Apple Account,-0.72,"1,024,246.95"
,26/07/2022,Transaction,,Online Sale,,EastX ****2310,-218.69,"1,024,028.26"
,26/07/2022,Transaction,,SHOP SALE,,EastX ****2310,-97.24,"1,023,931.02"
,26/07/2022,Transaction,,SHOP SALE,,Apple Account,-2.01,"1,023,929.01"
,26/07/2022,Transaction,,SHOP SALE,,EastX ****2310,-57.38,"1,023,871.63"
,26/07/2022,Transaction,,SHOP SALE,,Apple Account,-0.69,"1,023,870.94"
,26/07/2022,Transaction,,SHOP SALE,,Apple Account,-3.27,"1,023,867.67"
,26/07/2022,Transaction,,SHOP SALE,,EastX ****2310,-9.72,"1,023,857.95"
,26/07/2022,Transaction,,SHOP SALE,,EastX ****2310,-315.09,"1,023,542.86"
,26/07/2022,Transaction,,SHOP SALE,,EastX ****2310,-171.55,"1,023,371.31"
,26/07/2022,Transaction,,SHOP SALE,,EastX ****2310,-193.53,"1,023,177.78"
,26/07/2022,Transaction,,SHOP SALE,,Apple Account,-3.27,"1,023,174.51"
,26/07/2022,Transaction,,SHOP SALE,,EastX ****2310,-14.59,"1,023,159.92"
,26/07/2022,Transaction,,SHOP SALE,,EastX ****2310,-70.99,"1,023,088.93"
,26/07/2022,Transaction,,SHOP SALE,,EastX ****2310,-55.43,"1,023,033.50"
,26/07/2022,Transaction,,SHOP SALE,,EastX ****2310,-96.28,"1,022,937.22"
,26/07/2022,Transaction,,SHOP SALE,,EastX ****2310,-24.31,"1,022,912.91"
,26/07/2022,Transaction,,SHOP SALE,,Apple Account,-8.22,"1,022,904.69"
,26/07/2022,Transaction,,SHOP SALE,,EastX ****2310,-24.31,"1,022,880.38"
,26/07/2022,Transaction,,SHOP SALE,,EastX ****2310,-101.14,"1,022,779.24"
,26/07/2022,Transaction,,SHOP SALE,,Apple Account,-2.86,"1,022,776.38"
,26/07/2022,Transaction,,SHOP SALE,,Apple Account,-3.41,"1,022,772.97"
,26/07/2022,Transaction,,SHOP SALE,,EastX ****2310,-14.59,"1,022,758.38"
,26/07/2022,Transaction,,SHOP SALE,,EastX ****2310,-24.31,"1,022,734.07"
,26/07/2022,Transaction,,SHOP SALE,,EastX ****2310,-48.62,"1,022,685.45"
,26/07/2022,Transaction,,SHOP SALE,,Apple Account,-0.41,"1,022,685.04"
,26/07/2022,Transaction,,SHOP SALE,,EastX ****2310,-96.28,"1,022,588.76"
,26/07/2022,Transaction,,SHOP SALE,,Apple Account,-4.85,"1,022,583.91"
,26/07/2022,Transaction,,SHOP SALE,,Apple Account,-6.74,"1,022,577.17"
,26/07/2022,Transaction,,SHOP SALE,,Apple Account,-1.38,"1,022,575.79"
,26/07/2022,Transaction,,SHOP SALE,,EastX ****2310,-456.1,"1,022,119.69"
,26/07/2022,Transaction,,SHOP SALE,,Apple Account,-6.74,"1,022,112.95"
,26/07/2022,Transaction,,Online Sale,,Apple Account,-7.64,"1,022,105.31"
,26/07/2022,Transaction,,Online Sale,,Apple Account,-3.31,"1,022,102.00"
,26/07/2022,Transaction,,SHOP SALE,,EastX ****2310,-38.9,"1,022,063.10"
,26/07/2022,Transaction,,SHOP SALE,,EastX ****2310,-175.05,"1,021,888.05"
,26/07/2022,Transaction,,SHOP SALE,,EastX ****2310,-24.31,"1,021,863.74"
,26/07/2022,Transaction,,SHOP SALE,,EastX ****2310,-95.3,"1,021,768.44"
,26/07/2022,Transaction,,SHOP SALE,,EastX ****2310,-24.31,"1,021,744.13"
,26/07/2022,Transaction,,SHOP SALE,,Apple Account,-2.34,"1,021,741.79"
,26/07/2022,Transaction,,SHOP SALE,,Apple Account,-1.62,"1,021,740.17"
,26/07/2022,Transaction,,SHOP SALE,,Apple Account,-1.35,"1,021,738.82"
,26/07/2022,Transaction,,SHOP SALE,,Apple Account,-0.69,"1,021,738.13"
,26/07/2022,Transaction,,SHOP SALE,,Apple Account,-0.69,"1,021,737.44"
,26/07/2022,Transaction,,SHOP SALE,,EastX ****2310,-48.62,"1,021,688.82"
,26/07/2022,Transaction,,SHOP SALE,,Apple Account,-0.69,"1,021,688.13"
,26/07/2022,Transaction,,SHOP SALE,,Apple Account,-2.72,"1,021,685.41"
,26/07/2022,Transaction,,SHOP SALE,,EastX ****2310,-115.73,"1,021,569.68"
,26/07/2022,Transaction,,SHOP SALE,,EastX ****2310,-24.31,"1,021,545.37"
,26/07/2022,Transaction,,SHOP SALE,,Apple Account,-2.04,"1,021,543.33"
,26/07/2022,Transaction,,SHOP SALE,,Apple Account,-1.57,"1,021,541.76"
,26/07/2022,Transaction,,SHOP SALE,,EastX ****2310,-163.38,"1,021,378.38"
,26/07/2022,Transaction,,SHOP SALE,,Apple Account,-0.55,"1,021,377.83"
,26/07/2022,Transaction,,SHOP SALE,,EastX ****2310,-96.28,"1,021,281.55"
,26/07/2022,Transaction,,SHOP SALE,,EastX ****2310,-14.59,"1,021,266.96"
,26/07/2022,Transaction,,SHOP SALE,,Apple Account,-2.72,"1,021,264.24"
,26/07/2022,Transaction,,SHOP SALE,,EastX ****2310,-238.26,"1,021,025.98"
,26/07/2022,Transaction,,SHOP SALE,,Apple Account,-0.55,"1,021,025.43"
,26/07/2022,Transaction,,SHOP SALE,,EastX ****2310,-19.45,"1,021,005.98"
,26/07/2022,Transaction,,SHOP SALE,,Apple Account,-0.69,"1,021,005.29"
,26/07/2022,Transaction,,SHOP SALE,,EastX ****2310,-47.65,"1,020,957.64"
,26/07/2022,Transaction,,SHOP SALE,,EastX ****2310,-24.31,"1,020,933.33"
,26/07/2022,Transaction,,Online Sale,,EastX ****2310,-69.81,"1,020,863.52"
,26/07/2022,Transaction,,SHOP SALE,,Apple Account,-1.57,"1,020,861.95"
,26/07/2022,Transaction,,SHOP SALE,,Apple Account,-0.41,"1,020,861.54"
,26/07/2022,Transaction,,SHOP SALE,,Apple Account,-2.48,"1,020,859.06"
,26/07/2022,Transaction,,SHOP SALE,,Apple Account,-1.57,"1,020,857.49"
,26/07/2022,Transaction,,SHOP SALE,,EastX ****2310,-24.31,"1,020,833.18"
,26/07/2022,Transaction,,SHOP SALE,,Apple Account,-2.39,"1,020,830.79"
,26/07/2022,Transaction,,SHOP SALE,,Apple Account,-3.8,"1,020,826.99"
,26/07/2022,Transaction,,SHOP SALE,,EastX ****2310,-38.9,"1,020,788.09"
,26/07/2022,Transaction,,SHOP SALE,,Apple Account,-0.69,"1,020,787.40"
,26/07/2022,Transaction,,SHOP SALE,,Apple Account,-0.69,"1,020,786.71"
,26/07/2022,Transaction,,SHOP SALE,,Apple Account,-1.35,"1,020,785.36"
,26/07/2022,Transaction,,SHOP SALE,,EastX ****2310,-57.38,"1,020,727.98"
,26/07/2022,Transaction,,SHOP SALE,,EastX ****2310,-24.31,"1,020,703.67"
,26/07/2022,Transaction,,Online Sale,,Apple Account,-1.19,"1,020,702.48"
,26/07/2022,Transaction,,SHOP SALE,,Apple Account,-3.55,"1,020,698.93"
,26/07/2022,Transaction,,SHOP SALE,,EastX ****2310,-115.73,"1,020,583.20"
,26/07/2022,Transaction,,SHOP SALE,,Apple Account,-4.14,"1,020,579.06"
,26/07/2022,Transaction,,SHOP SALE,,Apple Account,-1.38,"1,020,577.68"
,26/07/2022,Transaction,,SHOP SALE,,EastX ****2310,-24.31,"1,020,553.37"
,26/07/2022,Transaction,,SHOP SALE,,EastX ****2310,-24.31,"1,020,529.06"
,26/07/2022,Transaction,,Online Sale,,EastX ****2310,-128.97,"1,020,400.09"
,26/07/2022,Transaction,,SHOP SALE,,Apple Account,-5.47,"1,020,394.62"
,26/07/2022,Transaction,,SHOP SALE,,Apple Account,-1.38,"1,020,393.24"
,26/07/2022,Transaction,,SHOP SALE,,EastX ****2310,-47.65,"1,020,345.59"
,26/07/2022,Transaction,,SHOP SALE,,EastX ****2310,-55.43,"1,020,290.16"
,26/07/2022,Transaction,,SHOP SALE,,Apple Account,-0.69,"1,020,289.47"
,26/07/2022,Transaction,,SHOP SALE,,Apple Account,-1.79,"1,020,287.68"
,26/07/2022,Transaction,,SHOP SALE,,EastX ****2310,-19.45,"1,020,268.23"
,26/07/2022,Transaction,,SHOP SALE,,EastX ****2310,-48.62,"1,020,219.61"
,26/07/2022,Transaction,,SHOP SALE,,EastX ****2310,-8.75,"1,020,210.86"
,26/07/2022,Transaction,,SHOP SALE,,EastX ****2310,-145.86,"1,020,065.00"
,26/07/2022,Transaction,,SHOP SALE,,Apple Account,-0.69,"1,020,064.31"
,26/07/2022,Transaction,,SHOP SALE,,Apple Account,-1.1,"1,020,063.21"
,26/07/2022,Transaction,,SHOP SALE,,Apple Account,-2.72,"1,020,060.49"
,26/07/2022,Transaction,,SHOP SALE,,EastX ****2310,-116.7,"1,019,943.79"
,26/07/2022,Transaction,,SHOP SALE,,EastX ****2310,-134.2,"1,019,809.59"
,26/07/2022,Transaction,,SHOP SALE,,Apple Account,-1.57,"1,019,808.02"
,26/07/2022,Transaction,,SHOP SALE,,EastX ****2310,-24.31,"1,019,783.71"
,26/07/2022,Transaction,,SHOP SALE,,EastX ****2310,-96.28,"1,019,687.43"
,26/07/2022,Transaction,,SHOP SALE,,Apple Account,-0.69,"1,019,686.74"
,26/07/2022,Transaction,,SHOP SALE,,EastX ****2310,-24.31,"1,019,662.43"
,26/07/2022,Transaction,,SHOP SALE,,Apple Account,-2.26,"1,019,660.17"
,26/07/2022,Transaction,,SHOP SALE,,Apple Account,-0.69,"1,019,659.48"
,26/07/2022,Transaction,,SHOP SALE,,Apple Account,-1.62,"1,019,657.86"
,26/07/2022,Transaction,,SHOP SALE,,Apple Account,-6.74,"1,019,651.12"
,26/07/2022,Transaction,,SHOP SALE,,EastX ****2310,-55.43,"1,019,595.69"
,26/07/2022,Transaction,,SHOP SALE,,EastX ****2310,-71.96,"1,019,523.73"
,26/07/2022,Transaction,,SHOP SALE,,Apple Account,-1.62,"1,019,522.11"
,26/07/2022,Transaction,,SHOP SALE,,Apple Account,-0.55,"1,019,521.56"
,26/07/2022,Transaction,,SHOP SALE,,EastX ****2310,-115.73,"1,019,405.83"
,26/07/2022,Transaction,,SHOP SALE,,EastX ****2310,-47.65,"1,019,358.18"
,26/07/2022,Transaction,,SHOP SALE,,Apple Account,-3.41,"1,019,354.77"
,26/07/2022,Transaction,,SHOP SALE,,Apple Account,-3.27,"1,019,351.50"
,26/07/2022,Transaction,,SHOP SALE,,Apple Account,-1.1,"1,019,350.40"
,26/07/2022,Transaction,,SHOP SALE,,Apple Account,-2.76,"1,019,347.64"
,26/07/2022,Transaction,,SHOP SALE,,EastX ****2310,-238.26,"1,019,109.38"
,26/07/2022,Transaction,,SHOP SALE,,EastX ****2310,-125.45,"1,018,983.93"
,26/07/2022,Transaction,,SHOP SALE,,EastX ****2310,-96.28,"1,018,887.65"
,26/07/2022,Transaction,,SHOP SALE,,EastX ****2310,-120.59,"1,018,767.06"
,26/07/2022,Transaction,,SHOP SALE,,EastX ****2310,-57.38,"1,018,709.68"
,26/07/2022,Transaction,,SHOP SALE,,EastX ****2310,-47.65,"1,018,662.03"
,26/07/2022,Transaction,,SHOP SALE,,Apple Account,-3.63,"1,018,658.40"
,26/07/2022,Transaction,,SHOP SALE,,EastX ****2310,-24.31,"1,018,634.09"
,27/07/2022,Receipt,12722,Online Sale,,Sales of Product Income:Non UK Sales,60.83,"1,018,694.92"
,27/07/2022,Transaction,,Online Sale,,Apple Account,-1.96,"1,018,692.96"
,27/07/2022,Transaction,,Online Sale,,EastX ****2310,-58.87,"1,018,634.09"
,28/07/2022,Transaction,,Online Sale,,Apple Account,-1.47,"1,018,632.62"
,28/07/2022,Receipt,12724,Online Sale,,Sales of Product Income:UK Sales,91,"1,018,723.62"
,30/07/2022,Receipt,12739,Armurerie Nouvelle,,-Split-,945,"1,019,668.62"
,30/07/2022,Receipt,12562,Northwood Group UK,,-Split-,"2,076.00","1,021,744.62"
,30/07/2022,Receipt,12563,SHOP SALE,,Sales of Product Income:Non UK Sales,0,"1,021,744.62"
,30/07/2022,Receipt,12740,Online Sale,,Sales of Product Income:Non UK Sales,45.83,"1,021,790.45"
,30/07/2022,Receipt,12734,SHOP SALE,,Sales of Product Income:UK Sales,0,"1,021,790.45"
,30/07/2022,Receipt,12728,Ifzaal  Musa,,-Split-,"6,760.00","1,028,550.45"
,30/07/2022,Receipt,12749,Outdoor Outfitters,,-Split-,"109,860.00","1,138,410.45"
,30/07/2022,Receipt,12741,Online Sale,,Sales of Product Income:Non UK Sales,144.17,"1,138,554.62"
,30/07/2022,Receipt,12729,Armurerie Nouvelle,,-Split-,"7,800.00","1,146,354.62"
,30/07/2022,Receipt,12732,Ve?koobchod zbrane spol. s.r.o.,,-Split-,"5,787.00","1,152,141.62"
,30/07/2022,Receipt,12725,David Austin,,-Split-,"8,400.00","1,160,541.62"
,30/07/2022,Debit Memo,12731,Gut Grambow SonySports GmbH,,Sales of Product Income:Non UK Sales,"-1,000.00","1,159,541.62"
,30/07/2022,Receipt,12726,Armurerie Richard,,-Split-,"7,367.00","1,166,908.62"
,30/07/2022,Receipt,12735,Mike Jines,,-Split-,37.7,"1,166,946.32"
,30/07/2022,Receipt,12737,Holt's,,-Split-,225.86,"1,167,172.18"
,30/07/2022,Receipt,12750,Tom Shaffer,,-Split-,"26,482.88","1,193,655.06"
,30/07/2022,Receipt,12733,Northwood USA 1,,-Split-,"53,376.00","1,247,031.06"
,30/07/2022,Receipt,12730,John Doe,,-Split-,"3,131.67","1,250,162.73"
,30/07/2022,Receipt,12727,Francesco Lenzerini,,Sales of Product Income:Non UK Sales,"5,600.00","1,255,762.73"
,30/07/2022,Receipt,12738,Mark Heath,,-Split-,108,"1,255,870.73"
,30/07/2022,Receipt,12742,Online Sale,,Sales of Product Income:Non UK Sales,320.83,"1,256,191.56"
,30/07/2022,Receipt,12736,Ifzaal  Musa,,-Split-,"1,794.00","1,257,985.56"
,30/07/2022,Transaction,,Online Sale,,Apple Account,-9.5,"1,257,976.06"
,30/07/2022,Transaction,,Online Sale,,Apple Account,-4.38,"1,257,971.68"
,30/07/2022,Transaction,,Russell Gordy,,EastX Bank,"-75,000.00","1,182,971.68"
,30/07/2022,Transaction,,HH Sheikh Mohammed Al-Sharqi,,Apple Account,-12,"1,182,959.68"
,30/07/2022,Transaction,,HH Sheikh Mohammed Al-Sharqi,,EastX Bank,"-99,988.00","1,082,971.68"
,30/07/2022,Transaction,,Online Sale,,Apple Account,-0.84,"1,082,970.84"
,31/07/2022,Receipt,12743,Online Sale,,Sales of Product Income:Non UK Sales,641.5,"1,083,612.34"
,31/07/2022,Receipt,12744,Online Sale,,Sales of Product Income:Non UK Sales,106.67,"1,083,719.01"
,31/07/2022,Transaction,,Online Sale,,Apple Account,-18.8,"1,083,700.21"
,31/07/2022,Transaction,,Online Sale,,Apple Account,-3.29,"1,083,696.92"
,2/8/2022,Receipt,12752,EBN Hunting,,-Split-,"1,074.60","1,084,771.52"
,2/8/2022,Receipt,12751,SAS Hunting Club Consulting,,-Split-,261.9,"1,085,033.42"
,2/8/2022,Receipt,12745,Dan Walker,,-Split-,51,"1,085,084.42"
,2/8/2022,Receipt,12748,John Reed,,Sales of Product Income:Non UK Sales,"2,244.00","1,087,328.42"
,2/8/2022,Transaction,,Online Sale,,EastX ****2310,-311.33,"1,087,017.09"
,2/8/2022,Transaction,,Online Sale,,EastX ****2310,-103.38,"1,086,913.71"
,2/8/2022,Transaction,,Online Sale,,EastX ****2310,-89.53,"1,086,824.18"
,2/8/2022,Transaction,,Online Sale,,EastX ****2310,-139.79,"1,086,684.39"
,2/8/2022,Transaction,,Mike Jines,,EastX  Saver ****7829,-37.7,"1,086,646.69"
,2/8/2022,Transaction,,Hartmann & Weiss GmbH,,EastX Bank,-529.65,"1,086,117.04"
,3/8/2022,Receipt,12755,Online Sale,,Sales of Product Income:Non UK Sales,151.66,"1,086,268.70"
,3/8/2022,Receipt,12753,Online Sale,,Sales of Product Income:Non UK Sales,65.83,"1,086,334.53"
,3/8/2022,Receipt,12757,SHOP SALE,,Sales of Product Income:UK Sales,0,"1,086,334.53"
,3/8/2022,Receipt,12754,Online Sale,,Sales of Product Income:Non UK Sales,145.83,"1,086,480.36"
,3/8/2022,Transaction,,Online Sale,,EastX ****2310,-147.07,"1,086,333.29"
,3/8/2022,Transaction,,Online Sale,,EastX ****2310,-44.99,"1,086,288.30"
,3/8/2022,Transaction,,Online Sale,,EastX ****2310,-622.7,"1,085,665.60"
,3/8/2022,Transaction,,Online Sale,,Apple Account,-1.12,"1,085,664.48"
,3/8/2022,Transaction,,Online Sale,,EastX ****2310,-143.59,"1,085,520.89"
,3/8/2022,Transaction,,Online Sale,,EastX ****2310,-64.71,"1,085,456.18"
,3/8/2022,Transaction,,Online Sale,,Apple Account,-4.59,"1,085,451.59"
,3/8/2022,Transaction,,Online Sale,,Apple Account,-2.24,"1,085,449.35"
,4/8/2022,Receipt,12758,Online Sale,,Sales of Product Income:UK Sales,37,"1,085,486.35"
,4/8/2022,Receipt,12759,Online Sale,,Sales of Product Income:Non UK Sales,190,"1,085,676.35"
,4/8/2022,Receipt,12763,Robert Sanderlin,,-Split-,149.5,"1,085,825.85"
,4/8/2022,Receipt,12760,Gut Grambow SonySports GmbH,,-Split-,52,"1,085,877.85"
,4/8/2022,Transaction,,Mr R Holden,,EastX Bank,"-81,850.00","1,004,027.85"
,4/8/2022,Transaction,,Online Sale,,EastX ****2310,-36.28,"1,003,991.57"
,4/8/2022,Transaction,,Online Sale,,Apple Account,-0.72,"1,003,990.85"
,4/8/2022,Transaction,,Online Sale,,EastX ****2310,-187.14,"1,003,803.71"
,4/8/2022,Transaction,,Corey Knowlton,,-Split-,,"1,003,803.71"
,4/8/2022,Transaction,,Gut Grambow SonySports GmbH,,-Split-,,"1,003,803.71"
,4/8/2022,Transaction,,Online Sale,,Apple Account,-2.86,"1,003,800.85"
,4/8/2022,Transaction,,Marc  Hillermann,,EastX Bank,"-3,343.92","1,000,456.93"
,5/8/2022,Receipt,12765,Tamas,,Sales of Product Income:UK Sales,17.38,"1,000,474.31"
,5/8/2022,Receipt,12764,Online Sale,,Sales of Product Income:Non UK Sales,"1,525.00","1,001,999.31"
,5/8/2022,Transaction,,Tamas,,EastX  Saver ****7829,-17.38,"1,001,981.93"
,5/8/2022,Transaction,,Online Sale,,Apple Account,-21.55,"1,001,960.38"
,5/8/2022,Transaction,,Online Sale,,EastX ****2310,"-1,503.45","1,000,456.93"
,6/8/2022,Receipt,12769,SHOP SALE,,-Split-,196,"1,000,652.93"
,6/8/2022,Receipt,12767,Charles Lesser,,-Split-,189,"1,000,841.93"
,6/8/2022,Receipt,12766,SHOP SALE,,Sales of Product Income:UK Sales,83.03,"1,000,924.96"
,6/8/2022,Debit Memo,12768,Charles Lesser,,Sales of Product Income:Non UK Sales,-357,"1,000,567.96"
,6/8/2022,Transaction,,SHOP SALE,,EastX  Saver ****7829,-196,"1,000,371.96"
,6/8/2022,Transaction,,SHOP SALE,,EastX  Saver ****7829,-83.03,"1,000,288.93"
,6/8/2022,Transaction,,Charles Lesser,,-Split-,,"1,000,288.93"
,6/8/2022,Transaction,,Charles Lesser,,EastX  Saver ****7829,-189,"1,000,099.93"
,6/8/2022,Transaction,,Robert Sanderlin,,EastX  Saver ****7829,-149.5,"999,950.43"
,9/8/2022,Receipt,12772,Online Sale,,Sales of Product Income:UK Sales,71,"1,000,021.43"
,9/8/2022,Transaction,,Online Sale,,EastX ****2310,-36.28,"999,985.15"
,9/8/2022,Transaction,,Online Sale,,EastX ****2310,-97.71,"999,887.44"
,9/8/2022,Transaction,,SHOP SALE,,EastX  Saver ****7829,-170,"999,717.44"
,9/8/2022,Transaction,,Online Sale,,Apple Account,-3.8,"999,713.64"
,9/8/2022,Transaction,,Online Sale,,Apple Account,-1.19,"999,712.45"
,9/8/2022,Transaction,,Online Sale,,EastX ****2310,-253.2,"999,459.25"
,9/8/2022,Transaction,,Northwood USA 1,,Apple Account,"-6,148.60","993,310.65"
,9/8/2022,Transaction,,Online Sale,,EastX ****2310,-69.81,"993,240.84"
,9/8/2022,Transaction,,Online Sale,,Apple Account,-3.12,"993,237.72"
,9/8/2022,Receipt,12776,Online Sale,,Sales of Product Income:UK Sales,37,"993,274.72"
,9/8/2022,Receipt,12774,Online Sale,,Sales of Product Income:Non UK Sales,100.83,"993,375.55"
,9/8/2022,Receipt,12773,Online Sale,,Sales of Product Income:Non UK Sales,385.83,"993,761.38"
,9/8/2022,Receipt,12775,Online Sale,,Sales of Product Income:UK Sales,257,"994,018.38"
,9/8/2022,Receipt,12771,Online Sale,,Sales of Product Income:UK Sales,82,"994,100.38"
,9/8/2022,Receipt,12777,SHOP SALE,,-Split-,170,"994,270.38"
,9/8/2022,Transaction,,Online Sale,,EastX ****2310,-80.65,"994,189.73"
,9/8/2022,Transaction,,Online Sale,,Apple Account,-1.35,"994,188.38"
,9/8/2022,Transaction,,Online Sale,,Apple Account,-11.39,"994,176.99"
,9/8/2022,Transaction,,Online Sale,,EastX ****2310,-374.44,"993,802.55"
,9/8/2022,Transaction,,Online Sale,,Apple Account,-0.72,"993,801.83"
,10/8/2022,Receipt,12781,The Traditional English cases Ltd,,Sales of Product Income:UK Sales,25,"993,826.83"
,10/8/2022,Transaction,,Online Sale,,EastX ****2310,-847.8,"992,979.03"
,10/8/2022,Receipt,12779,Online Sale,,Sales of Product Income:Non UK Sales,387.5,"993,366.53"
,10/8/2022,Receipt,12840,SHOP SALE,,Sales of Product Income:UK Sales,83.3,"993,449.83"
,10/8/2022,Receipt,12783,Online Sale,,Sales of Product Income:Non UK Sales,873.33,"994,323.16"
,10/8/2022,Receipt,12782,Andrew Loewy,,Sales of Product Income:UK Sales,40,"994,363.16"
,10/8/2022,Receipt,12778,Online Sale,,Sales of Product Income:Non UK Sales,83.33,"994,446.49"
,10/8/2022,Receipt,12780,David Austin,,Sales of Product Income:Non UK Sales,144,"994,590.49"
,10/8/2022,Transaction,,Online Sale,,Apple Account,-1.37,"994,589.12"
,10/8/2022,Transaction,,Online Sale,,EastX ****2310,-111.46,"994,477.66"
,10/8/2022,Transaction,,Online Sale,,Apple Account,-3.54,"994,474.12"
,10/8/2022,Transaction,,Online Sale,,Apple Account,-25.53,"994,448.59"
,10/8/2022,Transaction,,Online Sale,,EastX ****2310,-381.87,"994,066.72"
,10/8/2022,Transaction,,Online Sale,,EastX ****2310,-81.96,"993,984.76"
,10/8/2022,Transaction,,Online Sale,,Apple Account,-5.63,"993,979.13"
,10/8/2022,Transaction,,SHOP SALE,,EastX  Saver ****7829,-83.3,"993,895.83"
,10/8/2022,Receipt,12784,Online Sale,,Sales of Product Income:Non UK Sales,115,"994,010.83"
,11/8/2022,Receipt,12786,SHOP SALE,,Sales of Product Income:UK Sales,0,"994,010.83"
,11/8/2022,Transaction,,Andrew Loewy,,EastX  Saver ****7829,-40,"993,970.83"
,11/8/2022,Transaction,,Holt's,,EastX ****2310,-330.93,"993,639.90"
,11/8/2022,Receipt,12785,Holt's,,Sales of Product Income:UK Sales,330.93,"993,970.83"
,12/8/2022,Receipt,12843,SHOP SALE,,Sales of Product Income:UK Sales,25,"993,995.83"
,12/8/2022,Receipt,12790,Online Sale,,Sales of Product Income:Non UK Sales,325,"994,320.83"
,12/8/2022,Receipt,12789,SHOP SALE,,Sales of Product Income:Non UK Sales,155,"994,475.83"
,12/8/2022,Receipt,12842,Nelson Neto Junior,,Sales of Product Income:UK Sales,34.77,"994,510.60"
,12/8/2022,Receipt,12844,SHOP SALE,,Sales of Product Income:UK Sales,145,"994,655.60"
,12/8/2022,Receipt,12788,SHOP SALE,,Sales of Product Income:UK Sales,0,"994,655.60"
,12/8/2022,Transaction,,Nelson Neto Junior,,EastX  Saver ****7829,-34.77,"994,620.83"
,12/8/2022,Transaction,,SHOP SALE,,EastX  Saver ****7829,-155,"994,465.83"
,12/8/2022,Transaction,,Online Sale,,EastX ****2310,-315.37,"994,150.46"
,12/8/2022,Transaction,,SHOP SALE,,EastX  Saver ****7829,-25,"994,125.46"
,12/8/2022,Transaction,,SHOP SALE,,EastX  Saver ****7829,-145,"993,980.46"
,12/8/2022,Transaction,,Online Sale,,Apple Account,-9.63,"993,970.83"
,13/08/2022,Receipt,12839,SHOP SALE,,Sales of Product Income:Non UK Sales,162.4,"994,133.23"
,13/08/2022,Transaction,,Mark Heath,,EastX ****2310,-108,"994,025.23"
,13/08/2022,Transaction,,SHOP SALE,,EastX  Saver ****7829,-162.4,"993,862.83"
,16/08/2022,Receipt,12795,David Austin,,-Split-,"3,525.00","997,387.83"
,16/08/2022,Transaction,,Ve?koobchod zbrane spol. s.r.o.,,EastX Bank,"-5,787.00","991,600.83"
,16/08/2022,Receipt,12791,Adolfo Suarez Illana,,-Split-,370.83,"991,971.66"
,16/08/2022,Receipt,12792,Online Sale,,Sales of Product Income:Non UK Sales,249,"992,220.66"
,16/08/2022,Receipt,12793,Online Sale,,-Split-,27,"992,247.66"
,16/08/2022,Transaction,,Online Sale,,Apple Account,-7.42,"992,240.24"
,16/08/2022,Transaction,,Northwood USA 1,,EastX Bank,"-71,362.31","920,877.93"
,16/08/2022,Transaction,,EBN Hunting,,EastX Bank,-886.92,"919,991.01"
,16/08/2022,Transaction,,Online Sale,,EastX ****2310,-143.59,"919,847.42"
,16/08/2022,Transaction,,David Austin,,EastX Bank,"-13,000.00","906,847.42"
,16/08/2022,Transaction,,Online Sale,,EastX ****2310,-241.58,"906,605.84"
,16/08/2022,Transaction,,Mr Roger Karlsson,,EastX ****2310,"-8,698.80","897,907.04"
,16/08/2022,Transaction,,Online Sale,,Apple Account,-0.58,"897,906.46"
,16/08/2022,Transaction,,Online Sale,,EastX ****2310,-26.42,"897,880.04"
,16/08/2022,Transaction,,Online Sale,,Apple Account,-2.24,"897,877.80"
,16/08/2022,Receipt,12794,Online Sale,,Sales of Product Income:Non UK Sales,145.83,"898,023.63"
,17/08/2022,Transaction,,Northwood Group UK,,Apple Account,"-2,764.50","895,259.13"
,17/08/2022,Transaction,,Northwood Group GMBH,,Apple Account,"-16,107.00","879,152.13"
,18/08/2022,Transaction,,John Doe,,EastX Bank,"-3,131.67","876,020.46"
,19/08/2022,Transaction,,Sarfaraz Metlo,,EastX  Saver ****7829,"-3,000.00","873,020.46"
,19/08/2022,Receipt,12799,Mr Marc Newton,,Sales of Product Income:UK Sales,28.9,"873,049.36"
,23/08/2022,Receipt,12803,Northwood USA 1,,Sales of Product Income:Non UK Sales,"2,367.00","875,416.36"
,23/08/2022,Transaction,,Online Sale,,Apple Account,-1.96,"875,414.40"
,23/08/2022,Receipt,12802,Online Sale,,Sales of Product Income:Non UK Sales,458.33,"875,872.73"
,23/08/2022,Receipt,12801,Online Sale,,Sales of Product Income:Non UK Sales,190,"876,062.73"
,23/08/2022,Receipt,12798,Darach Albannach limited,,-Split-,211,"876,273.73"
,23/08/2022,Receipt,12804,Online Sale,,Sales of Product Income:Non UK Sales,60.83,"876,334.56"
,23/08/2022,Receipt,12800,Online Sale,,Sales of Product Income:Non UK Sales,66.67,"876,401.23"
,23/08/2022,Debit Memo,12797,David Austin,,-Split-,-49,"876,352.23"
,23/08/2022,Transaction,,Online Sale,,EastX ****2310,-65.54,"876,286.69"
,23/08/2022,Transaction,,David Austin,,-Split-,,"876,286.69"
,23/08/2022,Transaction,,Adolfo Suarez Illana,,EastX Bank,-370.83,"875,915.86"
,23/08/2022,Transaction,,Online Sale,,Apple Account,-1.13,"875,914.73"
,23/08/2022,Transaction,,Online Sale,,EastX ****2310,-187.14,"875,727.59"
,23/08/2022,Transaction,,Online Sale,,Apple Account,-6.62,"875,720.97"
,23/08/2022,Transaction,,Online Sale,,Apple Account,-2.86,"875,718.11"
,23/08/2022,Transaction,,Online Sale,,EastX ****2310,-451.71,"875,266.40"
,23/08/2022,Transaction,,Online Sale,,EastX ****2310,-58.87,"875,207.53"
,23/08/2022,Receipt,12796,SHOP SALE,,Sales of Product Income:UK Sales,0,"875,207.53"
,24/08/2022,Receipt,12805,Online Sale,,Sales of Product Income:Non UK Sales,485.83,"875,693.36"
,24/08/2022,Receipt,12808,SHOP SALE,,Sales of Product Income:UK Sales,0,"875,693.36"
,24/08/2022,Receipt,12809,Armurerie Nouvelle,,-Split-,"52,500.00","928,193.36"
,24/08/2022,Transaction,,Online Sale,,EastX ****2310,-26.42,"928,166.94"
,24/08/2022,Receipt,12807,Online Sale,,-Split-,27,"928,193.94"
,24/08/2022,Transaction,,Online Sale,,EastX ****2310,-471.54,"927,722.40"
,24/08/2022,Transaction,,Online Sale,,Apple Account,-14.29,"927,708.11"
,24/08/2022,Receipt,12806,Mary,,-Split-,24.08,"927,732.19"
,25/08/2022,Receipt,12814,Ifzaal  Musa,,Sales of Product Income:Non UK Sales,167,"927,899.19"
,25/08/2022,Transaction,,Gut Grambow SonySports GmbH,,EastX Bank,"-2,593.00","925,306.19"
,25/08/2022,Receipt,12816,Cameron Mitchell,,-Split-,65,"925,371.19"
,25/08/2022,Receipt,12812,Online Sale,,Sales of Product Income:Non UK Sales,100,"925,471.19"
,25/08/2022,Receipt,12815,Online Sale,,Sales of Product Income:Non UK Sales,270,"925,741.19"
,25/08/2022,Receipt,12810,SHOP SALE,,Sales of Product Income:UK Sales,99,"925,840.19"
,25/08/2022,Receipt,12811,SHOP SALE,,Sales of Product Income:UK Sales,15,"925,855.19"
,25/08/2022,Transaction,,Online Sale,,Apple Account,-3.98,"925,851.21"
,25/08/2022,Transaction,,HH Sheikh Mohammed Al-Sharqi,,EastX Bank,"-99,988.00","825,863.21"
,25/08/2022,Transaction,,Online Sale,,Apple Account,-0.58,"825,862.63"
,25/08/2022,Transaction,,Online Sale,,EastX ****2310,-98.4,"825,764.23"
,25/08/2022,Transaction,,SHOP SALE,,EastX  Saver ****7829,-99,"825,665.23"
,25/08/2022,Transaction,,Online Sale,,Apple Account,-1.6,"825,663.63"
,25/08/2022,Transaction,,SHOP SALE,,EastX  Saver ****7829,-15,"825,648.63"
,25/08/2022,Transaction,,Online Sale,,EastX ****2310,-266.02,"825,382.61"
,25/08/2022,Transaction,,HH Sheikh Mohammed Al-Sharqi,,Apple Account,-12,"825,370.61"
,25/08/2022,Receipt,12817,Jerome Lanoue,,Sales of Product Income:Non UK Sales,0,"825,370.61"
,26/08/2022,Receipt,12818,Online Sale,,Sales of Product Income:Non UK Sales,139.17,"825,509.78"
,26/08/2022,Receipt,12820,West London SS,,Sales of Product Income:UK Sales,0,"825,509.78"
,26/08/2022,Receipt,12822,Online Sale,,-Split-,27,"825,536.78"
,26/08/2022,Receipt,12823,Sarfaraz Metlo,,Sales of Product Income:Non UK Sales,770,"826,306.78"
,26/08/2022,Debit Memo,12824,Hannes Pickard,,Sales of Product Income:Non UK Sales,-220,"826,086.78"
,26/08/2022,Transaction,,Hannes Pickard,,-Split-,,"826,086.78"
,26/08/2022,Transaction,,Online Sale,,EastX ****2310,-134.93,"825,951.85"
,26/08/2022,Transaction,,Online Sale,,Apple Account,-4.24,"825,947.61"
,26/08/2022,Transaction,,Cameron Mitchell,,EastX  Saver ****7829,-65,"825,882.61"
,26/08/2022,Transaction,,Online Sale,,Apple Account,-0.58,"825,882.03"
,27/08/2022,Receipt,12827,Online Sale,,Sales of Product Income:Non UK Sales,154.17,"826,036.20"
,27/08/2022,Receipt,12825,Online Sale,,Sales of Product Income:Non UK Sales,107.5,"826,143.70"
,27/08/2022,Receipt,12826,Jerome Lanoue,,Sales of Product Income:Non UK Sales,0,"826,143.70"
,27/08/2022,Transaction,,Online Sale,,Apple Account,-4.67,"826,139.03"
,27/08/2022,Transaction,,Darach Albannach limited,,EastX Bank,-211,"825,928.03"
,27/08/2022,Transaction,,Online Sale,,Apple Account,-1.71,"825,926.32"
,27/08/2022,Receipt,12756,Northwood USA 1,,-Split-,"61,001.00","886,927.32"
,31/08/2022,Receipt,12832,Online Sale,,Sales of Product Income:Non UK Sales,91.67,"887,018.99"
,31/08/2022,Debit Memo,12762,Corey Knowlton,,Sales of Product Income:Non UK Sales,-192.93,"886,826.06"
,31/08/2022,Receipt,12847,Russell Gordy,,Sales of Product Income:Non UK Sales,"50,000.00","936,826.06"
,31/08/2022,Receipt,12837,martin levis,,Sales of Product Income:UK Sales,210,"937,036.06"
,31/08/2022,Receipt,12831,Online Sale,,Sales of Product Income:Non UK Sales,600,"937,636.06"
,31/08/2022,Receipt,12828,Online Sale,,Sales of Product Income:Non UK Sales,151.67,"937,787.73"
,31/08/2022,Receipt,12787,Sheikh Khalid Bin Ibrahim Al-Khalifa,,Sales of Product Income:Non UK Sales,"12,599.00","950,386.73"
,31/08/2022,Receipt,12829,Online Sale,,Sales of Product Income:UK Sales,87,"950,473.73"
,31/08/2022,Receipt,12834,Online Sale,,-Split-,211,"950,684.73"
,31/08/2022,Receipt,12833,Online Sale,,-Split-,27,"950,711.73"
,31/08/2022,Receipt,12835,Online Sale,,Sales of Product Income:Non UK Sales,70,"950,781.73"
,31/08/2022,Receipt,12830,Online Sale,,Sales of Product Income:UK Sales,197,"950,978.73"
,31/08/2022,Receipt,12846,Outdoor Outfitters,,-Split-,"135,250.40","1,086,229.13"
,31/08/2022,Transaction,,Online Sale,,Apple Account,-2.96,"1,086,226.17"
,31/08/2022,Transaction,,Online Sale,,Apple Account,-2.23,"1,086,223.94"
,31/08/2022,Transaction,,Online Sale,,Apple Account,-3.15,"1,086,220.79"
,31/08/2022,Transaction,,Online Sale,,Apple Account,-1.42,"1,086,219.37"
,31/08/2022,Transaction,,Online Sale,,Apple Account,-1.48,"1,086,217.89"
,31/08/2022,Transaction,,Online Sale,,Apple Account,-8.6,"1,086,209.29"
,31/08/2022,Transaction,,Online Sale,,Apple Account,-7.19,"1,086,202.10"
,31/08/2022,Transaction,,Online Sale,,Apple Account,-2.32,"1,086,199.78"
,31/08/2022,Transaction,,Online Sale,,Apple Account,-0.58,"1,086,199.20"
,31/08/2022,Receipt,12836,Online Sale,,Sales of Product Income:Non UK Sales,499.17,"1,086,698.37"
,1/9/2022,Receipt,12841,SHOP SALE,,Sales of Product Income:UK Sales,49,"1,086,747.37"
,1/9/2022,Transaction,,SHOP SALE,,EastX  Saver ****7829,-49,"1,086,698.37"
,1/9/2022,Transaction,,Holt's,,EastX ****2310,-225.86,"1,086,472.51"
,1/9/2022,Receipt,12860,SHOP SALE,,Sales of Product Income:UK Sales,75,"1,086,547.51"
,2/9/2022,Receipt,12849,Online Sale,,Sales of Product Income:Non UK Sales,225,"1,086,772.51"
,2/9/2022,Transaction,,Chris Dianda,,EastX  Saver ****7829,"-60,000.00","1,026,772.51"
,2/9/2022,Receipt,12852,Chris Dianda,,-Split-,"60,000.00","1,086,772.51"
,2/9/2022,Receipt,12850,SHOP SALE,,-Split-,27,"1,086,799.51"
,2/9/2022,Debit Memo,12851,Sarfaraz Metlo,,Sales of Product Income:Non UK Sales,-29.34,"1,086,770.17"
,2/9/2022,Transaction,,Sarfaraz Metlo,,EastX  Saver ****7829,-621,"1,086,149.17"
,2/9/2022,Transaction,,Online Sale,,EastX ****2310,-491.98,"1,085,657.19"
,2/9/2022,Transaction,,Online Sale,,EastX ****2310,-105.79,"1,085,551.40"
,2/9/2022,Transaction,,Sarfaraz Metlo,,-Split-,,"1,085,551.40"
,2/9/2022,Transaction,,Online Sale,,EastX ****2310,-26.42,"1,085,524.98"
,2/9/2022,Transaction,,Online Sale,,EastX ****2310,-149.5,"1,085,375.48"
,2/9/2022,Transaction,,Online Sale,,EastX ****2310,-207.85,"1,085,167.63"
,2/9/2022,Transaction,,Online Sale,,EastX ****2310,-591.4,"1,084,576.23"
,2/9/2022,Transaction,,Tom Shaffer,,EastX Bank,"-26,482.88","1,058,093.35"
,2/9/2022,Transaction,,Online Sale,,EastX ****2310,-85.58,"1,058,007.77"
,2/9/2022,Transaction,,Online Sale,,EastX ****2310,-26.42,"1,057,981.35"
,2/9/2022,Transaction,,Online Sale,,EastX ****2310,-67.77,"1,057,913.58"
,2/9/2022,Transaction,,SHOP SALE,,EastX  Saver ****7829,-27,"1,057,886.58"
,2/9/2022,Transaction,,Online Sale,,EastX ****2310,-26.42,"1,057,860.16"
,2/9/2022,Transaction,,Online Sale,,Apple Account,-6.73,"1,057,853.43"
,2/9/2022,Transaction,,Online Sale,,EastX ****2310,-90.19,"1,057,763.24"
,2/9/2022,Transaction,,Online Sale,,EastX ****2310,-194.04,"1,057,569.20"
,2/9/2022,Transaction,,Online Sale,,EastX ****2310,-149.35,"1,057,419.85"
,2/9/2022,Transaction,,Online Sale,,Apple Account,-0.58,"1,057,419.27"
,2/9/2022,Transaction,,Online Sale,,EastX ****2310,-218.27,"1,057,201.00"
,2/9/2022,Transaction,,Sarfaraz Metlo,,EastX  Saver ****7829,-770,"1,056,431.00"
,2/9/2022,Receipt,12848,Online Sale,,-Split-,27,"1,056,458.00"
,3/9/2022,Receipt,12853,Online Sale,,Sales of Product Income:Non UK Sales,80.83,"1,056,538.83"
,3/9/2022,Receipt,12854,Northwood USA 1,,Sales of Product Income:Non UK Sales,"3,715.00","1,060,253.83"
,3/9/2022,Receipt,12855,SHOP SALE,,-Split-,42,"1,060,295.83"
,3/9/2022,Transaction,,Mary,,EastX  Saver ****7829,-24.08,"1,060,271.75"
,3/9/2022,Transaction,,martin levis,,EastX  Saver ****7829,-210,"1,060,061.75"
,3/9/2022,Transaction,,Online Sale,,EastX ****2310,-78.29,"1,059,983.46"
,3/9/2022,Transaction,,Online Sale,,Apple Account,-2.54,"1,059,980.92"
,3/9/2022,Transaction,,SHOP SALE,,EastX  Saver ****7829,-42,"1,059,938.92"
,6/9/2022,Receipt,12859,Online Sale,,Sales of Product Income:Non UK Sales,179.17,"1,060,118.09"
,6/9/2022,Transaction,,Online Sale,,Apple Account,-2.02,"1,060,116.07"
,6/9/2022,Receipt,12863,SHOP SALE,,Sales of Product Income:UK Sales,0,"1,060,116.07"
,6/9/2022,Receipt,12861,Edward Jonkler,,Sales of Product Income:UK Sales,25,"1,060,141.07"
,6/9/2022,Receipt,12858,Online Sale,,Sales of Product Income:UK Sales,130,"1,060,271.07"
,6/9/2022,Receipt,12857,Online Sale,,Sales of Product Income:Non UK Sales,96.67,"1,060,367.74"
,6/9/2022,Receipt,12862,SHOP SALE,,Sales of Product Income:UK Sales,100,"1,060,467.74"
,6/9/2022,Transaction,,Online Sale,,EastX ****2310,-127.98,"1,060,339.76"
,6/9/2022,Transaction,,Online Sale,,EastX ****2310,-176.46,"1,060,163.30"
,6/9/2022,Transaction,,Edward Jonkler,,EastX  Saver ****7829,-715,"1,059,448.30"
,6/9/2022,Transaction,,Mark Renmant,,EastX  Saver ****7829,-25.1,"1,059,423.20"
,6/9/2022,Transaction,,Online Sale,,Apple Account,-1.55,"1,059,421.65"
,6/9/2022,Transaction,,Online Sale,,EastX ****2310,-95.12,"1,059,326.53"
,6/9/2022,Transaction,,SHOP SALE,,EastX  Saver ****7829,-100,"1,059,226.53"
,6/9/2022,Transaction,,Online Sale,,Apple Account,-2.71,"1,059,223.82"
,6/9/2022,Receipt,12856,Mark Renmant,,Sales of Product Income:UK Sales,25.1,"1,059,248.92"
,7/9/2022,Receipt,12864,Outdoor Outfitters,,Sales of Product Income:Non UK Sales,160,"1,059,408.92"
,8/9/2022,Receipt,12866,Geoffrey Lignon,,Sales of Product Income:Non UK Sales,42.5,"1,059,451.42"
,8/9/2022,Receipt,12867,SHOP SALE,,Sales of Product Income:UK Sales,0,"1,059,451.42"
,8/9/2022,Receipt,12865,Gut Grambow SonySports GmbH,,-Split-,"2,525.00","1,061,976.42"
,8/9/2022,Transaction,,Gut Grambow SonySports GmbH,,-Split-,,"1,061,976.42"
,8/9/2022,Receipt,12869,Francesco Corra,,Sales of Product Income:Non UK Sales,748.3,"1,062,724.72"
,8/9/2022,Transaction,,Geoffrey Lignon,,EastX  Saver ****7829,-42.5,"1,062,682.22"
,8/9/2022,Receipt,12868,Armurerie Vouzelaud,,-Split-,"3,215.00","1,065,897.22"
,9/9/2022,Receipt,12872,Online Sale,,Sales of Product Income:Non UK Sales,141.67,"1,066,038.89"
,9/9/2022,Receipt,12870,Online Sale,,Sales of Product Income:UK Sales,121,"1,066,159.89"
,9/9/2022,Receipt,12871,Don Alberto Bailleres Gonzalez,,Sales of Product Income:Non UK Sales,"1,180.00","1,067,339.89"
,9/9/2022,Transaction,,Online Sale,,Apple Account,-4.55,"1,067,335.34"
,9/9/2022,Transaction,,Online Sale,,Apple Account,-2.18,"1,067,333.16"
,9/9/2022,Transaction,,Online Sale,,EastX ****2310,-139.49,"1,067,193.67"
,9/9/2022,Transaction,,Online Sale,,Apple Account,-1.89,"1,067,191.78"
,9/9/2022,Transaction,,Online Sale,,EastX ****2310,-119.11,"1,067,072.67"
,9/9/2022,Transaction,,Online Sale,,Apple Account,-1.12,"1,067,071.55"
,10/9/2022,Receipt,12876,SHOP SALE,,Sales of Product Income:UK Sales,127,"1,067,198.55"
,10/9/2022,Receipt,12877,martin levis,,Sales of Product Income:UK Sales,39,"1,067,237.55"
,10/9/2022,Transaction,,SHOP SALE,,EastX  Saver ****7829,-90,"1,067,147.55"
,10/9/2022,Transaction,,martin levis,,EastX  Saver ****7829,-39,"1,067,108.55"
,10/9/2022,Transaction,,SHOP SALE,,EastX  Saver ****7829,-127,"1,066,981.55"
,13/09/2022,Receipt,12879,Holt's,,Sales of Product Income:UK Sales,73.2,"1,067,054.75"
,13/09/2022,Receipt,12874,Online Sale,,Sales of Product Income:Non UK Sales,120.83,"1,067,175.58"
,13/09/2022,Receipt,12875,SHOP SALE,,Sales of Product Income:UK Sales,90,"1,067,265.58"
,13/09/2022,Receipt,12878,Vance Daigle,,Sales of Product Income:Non UK Sales,"12,000.00","1,079,265.58"
,13/09/2022,Receipt,12873,Online Sale,,Sales of Product Income:Non UK Sales,246.67,"1,079,512.25"
,13/09/2022,Transaction,,Online Sale,,EastX ****2310,-118.94,"1,079,393.31"
,13/09/2022,Transaction,,Armurerie Collard,,EastX Bank,-992.91,"1,078,400.40"
,13/09/2022,Transaction,,Online Sale,,Apple Account,-1.89,"1,078,398.51"
,13/09/2022,Transaction,,Online Sale,,EastX ****2310,-239.32,"1,078,159.19"
,13/09/2022,Transaction,,Online Sale,,Apple Account,-7.35,"1,078,151.84"
,13/09/2022,Transaction,,Don Alberto Bailleres Gonzalez,,EastX Bank,"-1,180.00","1,076,971.84"
,14/09/2022,Transaction,,SHOP SALE,,EastX  Saver ****7829,-80,"1,076,891.84"
,14/09/2022,Transaction,,Outdoor Outfitters,,Apple Account,"-63,262.00","1,013,629.84"
,14/09/2022,Transaction,,SHOP SALE,,EastX  Saver ****7829,-25,"1,013,604.84"
,14/09/2022,Receipt,12882,SHOP SALE,,-Split-,25,"1,013,629.84"
,14/09/2022,Transaction,,Online Sale,,EastX ****2310,-26.42,"1,013,603.42"
,14/09/2022,Receipt,12881,Online Sale,,-Split-,27,"1,013,630.42"
,14/09/2022,Receipt,12883,SHOP SALE,,Sales of Product Income:UK Sales,80,"1,013,710.42"
,14/09/2022,Transaction,,Online Sale,,Apple Account,-0.58,"1,013,709.84"
,15/09/2022,Transaction,,SHOP SALE,,EastX  Saver ****7829,-59,"1,013,650.84"
,15/09/2022,Transaction,,Online Sale,,Apple Account,-2.93,"1,013,647.91"
,15/09/2022,Transaction,,Online Sale,,EastX ****2310,-185.1,"1,013,462.81"
,15/09/2022,Transaction,,Matthias Draxler,,EastX Bank,-84,"1,013,378.81"
,15/09/2022,Transaction,,Online Sale,,Apple Account,-3.83,"1,013,374.98"
,15/09/2022,Transaction,,Online Sale,,EastX ****2310,-91.24,"1,013,283.74"
,15/09/2022,Receipt,12884,HH Sheikh Mohammed Al-Sharqi,,Orders in Hand/Deferred Income,"12,500.00","1,025,783.74"
,15/09/2022,Transaction,,Online Sale,,EastX ****2310,-121.17,"1,025,662.57"
,15/09/2022,Receipt,12885,Northwood USA 1,,-Split-,"1,775.00","1,027,437.57"
,15/09/2022,Receipt,12889,SHOP SALE,,Sales of Product Income:UK Sales,59,"1,027,496.57"
,15/09/2022,Receipt,12887,Online Sale,,Sales of Product Income:Non UK Sales,94.17,"1,027,590.74"
,15/09/2022,Receipt,12888,Online Sale,,Sales of Product Income:Non UK Sales,190.83,"1,027,781.57"
,15/09/2022,Receipt,12886,Online Sale,,Sales of Product Income:Non UK Sales,125,"1,027,906.57"
,15/09/2022,Transaction,,Online Sale,,Apple Account,-5.73,"1,027,900.84"
,17/09/2022,Transaction,,Online Sale,,Apple Account,-2.52,"1,027,898.32"
,17/09/2022,Transaction,,Online Sale,,EastX ****2310,-163.31,"1,027,735.01"
,17/09/2022,Receipt,12890,Online Sale,,Sales of Product Income:Non UK Sales,165.83,"1,027,900.84"
,17/09/2022,Transaction,,Glenn Kendall,,EastX Bank,"-10,000.00","1,017,900.84"
,17/09/2022,Transaction,,Northwood USA 1,,Apple Account,"-5,503.17","1,012,397.67"
,20/09/2022,Transaction,,Bertrand  Batoux,,EastX  Saver ****7829,-264.75,"1,012,132.92"
,20/09/2022,Transaction,,Online Sale,,EastX ****2310,-65.54,"1,012,067.38"
,20/09/2022,Transaction,,Online Sale,,EastX ****2310,-108.26,"1,011,959.12"
,20/09/2022,Transaction,,Online Sale,,Apple Account,-1.13,"1,011,957.99"
,20/09/2022,Transaction,,Online Sale,,Apple Account,-1.74,"1,011,956.25"
,20/09/2022,Receipt,12895,HH Sheikh Mohammed Al-Sharqi,,-Split-,"20,000.00","1,031,956.25"
,20/09/2022,Receipt,12894,Maple Ranch,,-Split-,250,"1,032,206.25"
,20/09/2022,Receipt,12893,Bertrand  Batoux,,Sales of Product Income:Non UK Sales,264.75,"1,032,471.00"
,20/09/2022,Receipt,12896,HH Sheikh Mohammed Al-Sharqi,,Sales of Product Income:Non UK Sales,"1,200.00","1,033,671.00"
,20/09/2022,Receipt,12892,Online Sale,,Sales of Product Income:Non UK Sales,66.67,"1,033,737.67"
,20/09/2022,Receipt,12891,Online Sale,,Sales of Product Income:UK Sales,110,"1,033,847.67"
,20/09/2022,Transaction,,Vance Daigle,,EastX Bank,"-12,000.00","1,021,847.67"
,21/09/2022,Transaction,,Online Sale,,Apple Account,-7.63,"1,021,840.04"
,21/09/2022,Receipt,12897,Online Sale,,Sales of Product Income:Non UK Sales,530.83,"1,022,370.87"
,21/09/2022,Receipt,12898,Mike Botha,,Sales of Product Income:Non UK Sales,275,"1,022,645.87"
,21/09/2022,Receipt,12900,TXAT,,Orders in Hand/Deferred Income,"15,000.00","1,037,645.87"
,21/09/2022,Transaction,,Online Sale,,EastX ****2310,-523.2,"1,037,122.67"
,22/09/2022,Receipt,12901,SHOP SALE,,Sales of Product Income:UK Sales,0,"1,037,122.67"
,22/09/2022,Transaction,,Maple Ranch,,EastX  Saver ****7829,-250,"1,036,872.67"
,22/09/2022,Receipt,12902,Armurerie Vouzelaud,,-Split-,"1,090.00","1,037,962.67"
,24/09/2022,Transaction,,HH Sheikh Mohammed Al-Sharqi,,Apple Account,-12,"1,037,950.67"
,24/09/2022,Receipt,12906,Ve?koobchod zbrane spol. s.r.o.,,Sales of Product Income:Non UK Sales,312,"1,038,262.67"
,24/09/2022,Transaction,,Northwood USA 1,,EastX Bank,"-101,863.89","936,398.78"
,24/09/2022,Transaction,,Armurerie Vouzelaud,,EastX Bank,"-3,215.00","933,183.78"
,24/09/2022,Transaction,,HH Sheikh Mohammed Al-Sharqi,,EastX Bank,"-99,988.00","833,195.78"
,27/09/2022,Receipt,12908,Maple Ranch,,-Split-,930,"834,125.78"
,27/09/2022,Receipt,12903,Mauser Jagdwaffen GmbH,,Sales of Product Income:Non UK Sales,336,"834,461.78"
,27/09/2022,Receipt,12905,Online Sale,,Sales of Product Income:Non UK Sales,310.83,"834,772.61"
,27/09/2022,Transaction,,Mauser Jagdwaffen GmbH,,EastX Bank,-336,"834,436.61"
,27/09/2022,Transaction,,Online Sale,,Apple Account,-17.35,"834,419.26"
,27/09/2022,Transaction,,Online Sale,,EastX ****2310,-306.28,"834,112.98"
,27/09/2022,Receipt,12904,Online Sale,,Sales of Product Income:UK Sales,"1,225.00","835,337.98"
,27/09/2022,Receipt,12907,Armurerie Richard,,-Split-,"14,877.00","850,214.98"
,27/09/2022,Transaction,,Online Sale,,EastX ****2310,"-1,207.65","849,007.33"
,28/09/2022,Receipt,12910,Online Sale,,Sales of Product Income:Non UK Sales,65.83,"849,073.16"
,28/09/2022,Transaction,,Ifzaal  Musa,,EastX Bank,"-1,794.00","847,279.16"
,28/09/2022,Transaction,,Online Sale,,EastX ****2310,-64.71,"847,214.45"
,28/09/2022,Transaction,,Jung Jagd Sportwaffen,,EastX Bank,-103.43,"847,111.02"
,29/09/2022,Receipt,12913,SHOP SALE,,Sales of Product Income:UK Sales,49,"847,160.02"
,29/09/2022,Receipt,12911,SHOP SALE,,Sales of Product Income:UK Sales,0,"847,160.02"
,29/09/2022,Receipt,12912,SHOP SALE,,-Split-,424,"847,584.02"
,30/09/2022,Receipt,12915,Online Sale,,Sales of Product Income:Non UK Sales,243.33,"847,827.35"
,30/09/2022,Receipt,12813,Northwood USA 1,,-Split-,"84,047.00","931,874.35"
,30/09/2022,Transaction,,Online Sale,,Apple Account,-7.26,"931,867.09"
,30/09/2022,Transaction,,Online Sale,,Apple Account,-1.61,"931,865.48"
,30/09/2022,Receipt,12919,Richard haines,,Sales of Product Income:UK Sales,800,"932,665.48"
,30/09/2022,Receipt,12918,Outdoor Outfitters,,Sales of Product Income:Non UK Sales,250,"932,915.48"
,30/09/2022,Receipt,12924,Chip Mahan,,-Split-,"29,070.00","961,985.48"
,30/09/2022,Receipt,12916,Online Sale,,Sales of Product Income:UK Sales,101,"962,086.48"
,30/09/2022,Receipt,12914,Sheikh Mustufa Bin Abdullah,,Sales of Product Income:UK Sales,288,"962,374.48"
,30/09/2022,Receipt,12917,Thomas Hill,,Orders in Hand/Deferred Income,"31,500.00","993,874.48"
,30/09/2022,Transaction,,Northwood USA 1,,Apple Account,"-5,629.00","988,245.48"
,1/10/2022,Transaction,,SHOP SALE,,EastX  Saver ****7829,-35,"988,210.48"
,1/10/2022,Receipt,12923,SHOP SALE,,Sales of Product Income:UK Sales,35,"988,245.48"
,1/10/2022,Receipt,12925,Outdoor Outfitters,,-Split-,520,"988,765.48"
,1/10/2022,Receipt,12920,Online Sale,,Sales of Product Income:Non UK Sales,285.83,"989,051.31"
,1/10/2022,Receipt,12926,SHOP SALE,,Sales of Product Income:Non UK Sales,195,"989,246.31"
,1/10/2022,Transaction,,Chris Dianda,,EastX  Saver ****7829,"-50,000.00","939,246.31"
,1/10/2022,Receipt,12838,David Austin,,-Split-,"1,800.00","941,046.31"
,1/10/2022,Debit Memo,12921,Jung Jagd Sportwaffen,,Sales of Product Income:Non UK Sales,-1.57,"941,044.74"
,1/10/2022,Transaction,,SHOP SALE,,EastX  Saver ****7829,-195,"940,849.74"
,1/10/2022,Transaction,,Online Sale,,EastX ****2310,-277.34,"940,572.40"
,1/10/2022,Transaction,,Jung Jagd Sportwaffen,,-Split-,,"940,572.40"
,1/10/2022,Transaction,,Online Sale,,Apple Account,-8.49,"940,563.91"
,1/10/2022,Receipt,12922,Chris Dianda,,Orders in Hand/Deferred Income,"50,000.00","990,563.91"
,2/10/2022,Transaction,,SHOP SALE,,EastX  Saver ****7829,-75,"990,488.91"
,2/10/2022,Transaction,,Online Sale,,EastX ****2310,-236.07,"990,252.84"
,2/10/2022,Transaction,,Online Sale,,EastX ****2310,-99.39,"990,153.45"
,2/10/2022,Transaction,,Maple Ranch,,EastX  Saver ****7829,-930,"989,223.45"
,2/10/2022,Transaction,,SHOP SALE,,EastX  Saver ****7829,-424,"988,799.45"
,2/10/2022,Transaction,,Richard haines,,EastX  Saver ****7829,-800,"987,999.45"
,4/10/2022,Receipt,12928,Hartmann & Weiss GmbH,,Sales of Product Income:Non UK Sales,553.8,"988,553.25"
,4/10/2022,Receipt,12927,Online Sale,,Sales of Product Income:UK Sales,187,"988,740.25"
,4/10/2022,Transaction,,Online Sale,,EastX ****2310,-184.18,"988,556.07"
,4/10/2022,Transaction,,Online Sale,,Apple Account,-2.82,"988,553.25"
,5/10/2022,Receipt,12931,Online Sale,,Sales of Product Income:Non UK Sales,115,"988,668.25"
,5/10/2022,Transaction,,TXAT,,EastX Bank,"-15,000.00","973,668.25"
,5/10/2022,Transaction,,Online Sale,,EastX ****2310,-111.46,"973,556.79"
,5/10/2022,Transaction,,SHOP SALE,,EastX  Saver ****7829,-49,"973,507.79"
,5/10/2022,Transaction,,Online Sale,,Apple Account,-3.54,"973,504.25"
,5/10/2022,Transaction,,Sheikh Khalid Bin Ibrahim Al-Khalifa,,EastX  Saver ****7829,"-12,599.00","960,905.25"
,5/10/2022,Receipt,12930,Brian Groat,,-Split-,"2,844.00","963,749.25"
,6/10/2022,Transaction,,Online Sale,,Apple Account,-1.56,"963,747.69"
,6/10/2022,Transaction,,Online Sale,,EastX ****2310,-36.28,"963,711.41"
,6/10/2022,Transaction,,Online Sale,,EastX ****2310,-95.44,"963,615.97"
,6/10/2022,Receipt,12933,Online Sale,,Sales of Product Income:UK Sales,37,"963,652.97"
,6/10/2022,Receipt,12932,Online Sale,,Sales of Product Income:UK Sales,97,"963,749.97"
,6/10/2022,Receipt,12934,Mike Botha,,Sales of Product Income:Non UK Sales,"1,274.68","965,024.65"
,6/10/2022,Transaction,,Online Sale,,Apple Account,-0.72,"965,023.93"
,7/10/2022,Transaction,,Online Sale,,Apple Account,-3.54,"965,020.39"
,7/10/2022,Transaction,,Online Sale,,Apple Account,-2.19,"965,018.20"
,7/10/2022,Receipt,12935,Russell Gordy,,Sales of Product Income:Non UK Sales,"2,500.00","967,518.20"
,7/10/2022,Receipt,12941,Armurerie Nouvelle,,-Split-,500,"968,018.20"
,7/10/2022,Transaction,,Online Sale,,EastX ****2310,-111.46,"967,906.74"
,7/10/2022,Receipt,12940,Jerome Lanoue,,Sales of Product Income:Non UK Sales,0,"967,906.74"
,7/10/2022,Receipt,12938,SHOP SALE,,Sales of Product Income:UK Sales,180,"968,086.74"
,7/10/2022,Receipt,12939,Iain Child,,-Split-,132,"968,218.74"
,7/10/2022,Receipt,12936,Online Sale,,Sales of Product Income:Non UK Sales,115,"968,333.74"
,7/10/2022,Receipt,12937,Online Sale,,Sales of Product Income:UK Sales,142,"968,475.74"
,8/10/2022,Receipt,12947,Charles Lazenby,,Sales of Product Income:Sales,330,"968,805.74"
,8/10/2022,Receipt,12950,Online Sale,,Sales of Product Income:UK Sales,536,"969,341.74"
,8/10/2022,Receipt,12944,Francesco Lenzerini,,Sales of Product Income:Non UK Sales,"4,502.00","973,843.74"
,8/10/2022,Receipt,12951,Online Sale,,Sales of Product Income:UK Sales,131,"973,974.74"
,8/10/2022,Receipt,12945,Iain Child,,Sales of Product Income:Non UK Sales,897,"974,871.74"
,8/10/2022,Transaction,,Richard haines,,EastX  Saver ****7829,-50,"974,821.74"
,8/10/2022,Transaction,,Ve?koobchod zbrane spol. s.r.o.,,-Split-,,"974,821.74"
,8/10/2022,Transaction,,Charles Lazenby,,EastX  Saver ****7829,-330,"974,491.74"
,8/10/2022,Transaction,,Online Sale,,EastX ****2310,-128.97,"974,362.77"
,8/10/2022,Transaction,,Online Sale,,EastX ****2310,-528.3,"973,834.47"
,8/10/2022,Transaction,,Online Sale,,Apple Account,-2.03,"973,832.44"
,8/10/2022,Debit Memo,12946,Ve?koobchod zbrane spol. s.r.o.,,Sales of Product Income:Non UK Sales,-312,"973,520.44"
,8/10/2022,Transaction,,Online Sale,,Apple Account,-7.7,"973,512.74"
,11/10/2022,Receipt,12948,Armurerie Mallet,,-Split-,"1,280.00","974,792.74"
,11/10/2022,Transaction,,Francesco Corra,,Apple Account,-748.3,"974,044.44"
,11/10/2022,Receipt,12949,Richard haines,,Sales of Product Income:UK Sales,50,"974,094.44"
,11/10/2022,Receipt,12952,Cary Whitehead,,-Split-,320,"974,414.44"
,12/10/2022,Transaction,,Iain Child,,EastX Bank,-132,"974,282.44"
,12/10/2022,Transaction,,Armurerie Vouzelaud,,EastX Bank,"-1,090.00","973,192.44"
,12/10/2022,Transaction,,Cary Whitehead,,EastX  Saver ****7829,-320,"972,872.44"
,13/10/2022,Receipt,12961,SHOP SALE,,Sales of Product Income:UK Sales,0,"972,872.44"
,13/10/2022,Transaction,,Iain Child,,EastX Bank,-897,"971,975.44"
,13/10/2022,Transaction,,Tamas,,EastX  Saver ****7829,-281.07,"971,694.37"
,14/10/2022,Receipt,12955,Online Sale,,Sales of Product Income:UK Sales,61,"971,755.37"
,14/10/2022,Transaction,,Online Sale,,EastX ****2310,-105.79,"971,649.58"
,14/10/2022,Receipt,12963,SHOP SALE,,Sales of Product Income:UK Sales,99,"971,748.58"
,14/10/2022,Receipt,12956,Online Sale,,Sales of Product Income:Non UK Sales,70,"971,818.58"
,14/10/2022,Receipt,12953,Online Sale,,Sales of Product Income:Non UK Sales,194.17,"972,012.75"
,14/10/2022,Receipt,12960,Tamas,,Sales of Product Income:UK Sales,281.07,"972,293.82"
,14/10/2022,Receipt,12958,Online Sale,,Sales of Product Income:Non UK Sales,107.5,"972,401.32"
,14/10/2022,Receipt,12954,Online Sale,,Sales of Product Income:Non UK Sales,95,"972,496.32"
,14/10/2022,Receipt,12962,Darach Albannach limited,,Sales of Product Income:UK Sales,"3,722.40","976,218.72"
,14/10/2022,Receipt,12959,Lord Charles Aldington,,Sales of Product Income:Sales,325,"976,543.72"
,14/10/2022,Transaction,,Online Sale,,Apple Account,-1.53,"976,542.19"
,14/10/2022,Transaction,,Online Sale,,Apple Account,-5.83,"976,536.36"
,14/10/2022,Transaction,,Online Sale,,EastX ****2310,-67.77,"976,468.59"
,14/10/2022,Transaction,,Online Sale,,Apple Account,-1.71,"976,466.88"
,14/10/2022,Transaction,,Online Sale,,Apple Account,-2.23,"976,464.65"
,14/10/2022,Transaction,,Online Sale,,EastX ****2310,-59.95,"976,404.70"
,14/10/2022,Transaction,,Online Sale,,EastX ****2310,-188.34,"976,216.36"
,14/10/2022,Transaction,,SHOP SALE,,EastX  Saver ****7829,-99,"976,117.36"
,14/10/2022,Transaction,,Online Sale,,Apple Account,-1.05,"976,116.31"
,14/10/2022,Transaction,,Online Sale,,Apple Account,-1.53,"976,114.78"
,14/10/2022,Transaction,,Online Sale,,EastX ****2310,-93.47,"976,021.31"
,14/10/2022,Transaction,,Online Sale,,EastX ****2310,-93.47,"975,927.84"
,14/10/2022,Receipt,12957,Online Sale,,Sales of Product Income:UK Sales,95,"976,022.84"
,15/10/2022,Receipt,12964,Online Sale,,Sales of Product Income:UK Sales,37,"976,059.84"
,15/10/2022,Receipt,12965,Cary Whitehead,,-Split-,153.33,"976,213.17"
,15/10/2022,Transaction,,Cary Whitehead,,EastX  Saver ****7829,-153.33,"976,059.84"
,15/10/2022,Transaction,,Online Sale,,EastX ****2310,-36.28,"976,023.56"
,15/10/2022,Transaction,,Online Sale,,Apple Account,-0.72,"976,022.84"
,18/10/2022,Receipt,12969,Online Sale,,-Split-,51,"976,073.84"
,18/10/2022,Transaction,,Online Sale,,EastX ****2310,-110.72,"975,963.12"
,18/10/2022,Receipt,12971,Huw Thomas,,Sales of Product Income:Sales,200,"976,163.12"
,18/10/2022,Receipt,12968,Online Sale,,Sales of Product Income:Non UK Sales,107.5,"976,270.62"
,18/10/2022,Receipt,12970,Morten Kristoffer Kjus,,-Split-,104,"976,374.62"
,18/10/2022,Receipt,12972,Online Sale,,Sales of Product Income:Non UK Sales,112.5,"976,487.12"
,18/10/2022,Transaction,,Huw Thomas,,EastX  Saver ****7829,-200,"976,287.12"
,18/10/2022,Transaction,,Online Sale,,Apple Account,-1.6,"976,285.52"
,18/10/2022,Transaction,,Online Sale,,Apple Account,-0.91,"976,284.61"
,18/10/2022,Transaction,,Online Sale,,EastX ****2310,-50.09,"976,234.52"
,18/10/2022,Transaction,,Online Sale,,Apple Account,-1.71,"976,232.81"
,18/10/2022,Transaction,,Lord Charles Aldington,,EastX Bank,-325,"975,907.81"
,18/10/2022,Transaction,,Online Sale,,EastX ****2310,-105.79,"975,802.02"
,18/10/2022,Transaction,,Online Sale,,EastX ****2310,-46.73,"975,755.29"
,18/10/2022,Transaction,,Online Sale,,Apple Account,-1.78,"975,753.51"
,18/10/2022,Receipt,12967,Online Sale,,Sales of Product Income:Non UK Sales,48.33,"975,801.84"
,19/10/2022,Receipt,12977,Online Sale,,Sales of Product Income:Non UK Sales,461.67,"976,263.51"
,19/10/2022,Receipt,12974,SHOP SALE,,Sales of Product Income:UK Sales,60,"976,323.51"
,19/10/2022,Receipt,12975,Sheikh Abdullah Faisal Al-Thani,,Orders in Hand/Deferred Income,"23,750.00","1,000,073.51"
,19/10/2022,Receipt,12973,Simon Calcutt,,Sales of Product Income:Sales,180,"1,000,253.51"
,19/10/2022,Transaction,,Online Sale,,Apple Account,-6.66,"1,000,246.85"
,19/10/2022,Transaction,,Sheikh Abdullah Faisal Al-Thani,,EastX Bank,"-23,750.00","976,496.85"
,19/10/2022,Transaction,,SHOP SALE,,EastX  Saver ****7829,-60,"976,436.85"
,19/10/2022,Transaction,,Online Sale,,EastX ****2310,-455.01,"975,981.84"
,19/10/2022,Transaction,,Simon Calcutt,,EastX  Saver ****7829,-180,"975,801.84"
,20/10/2022,Receipt,12978,Online Sale,,Sales of Product Income:Non UK Sales,107.5,"975,909.34"
,20/10/2022,Receipt,12980,Online Sale,,Sales of Product Income:Non UK Sales,79.17,"975,988.51"
,20/10/2022,Receipt,12979,Armurerie Collard,,-Split-,"3,000.00","978,988.51"
,20/10/2022,Receipt,12981,SHOP SALE,,Sales of Product Income:UK Sales,20,"979,008.51"
,20/10/2022,Transaction,,Online Sale,,EastX ****2310,-77.86,"978,930.65"
,20/10/2022,Transaction,,Online Sale,,EastX ****2310,-105.79,"978,824.86"
,20/10/2022,Transaction,,SHOP SALE,,EastX  Saver ****7829,-20,"978,804.86"
,20/10/2022,Transaction,,Online Sale,,Apple Account,-1.31,"978,803.55"
,20/10/2022,Transaction,,SHOP SALE,,EastX  Saver ****7829,-75,"978,728.55"
,20/10/2022,Transaction,,Online Sale,,Apple Account,-1.71,"978,726.84"
,21/10/2022,Receipt,12985,Armurerie Richard,,-Split-,"2,720.00","981,446.84"
,21/10/2022,Transaction,,Online Sale,,EastX ****2310,-134.56,"981,312.28"
,21/10/2022,Transaction,,Online Sale,,EastX ****2310,-147.7,"981,164.58"
,21/10/2022,Transaction,,Online Sale,,Apple Account,-2.3,"981,162.28"
,21/10/2022,Receipt,12984,Online Sale,,Sales of Product Income:Non UK Sales,136.67,"981,298.95"
,21/10/2022,Transaction,,Online Sale,,Apple Account,-2.11,"981,296.84"
,21/10/2022,Receipt,12983,Online Sale,,Sales of Product Income:Non UK Sales,150,"981,446.84"
,22/10/2022,Receipt,12997,SHOP SALE,,Sales of Product Income:UK Sales,100,"981,546.84"
,22/10/2022,Receipt,12990,Corey Knowlton,,-Split-,"10,000.00","991,546.84"
,22/10/2022,Receipt,12991,Tarek Mahmoud,,Orders in Hand/Deferred Income,"19,575.00","1,011,121.84"
,22/10/2022,Receipt,12988,Northwood USA 1,,Sales of Product Income:Non UK Sales,"3,951.40","1,015,073.24"
,22/10/2022,Receipt,12992,John Pelly,,Sales of Product Income:Sales,700,"1,015,773.24"
,22/10/2022,Debit Memo,12989,Northwood USA 1,,Sales of Product Income:Non UK Sales,-950,"1,014,823.24"
,22/10/2022,Transaction,,Northwood USA 1,,-Split-,,"1,014,823.24"
,22/10/2022,Transaction,,Declan Morrison,,EastX Bank,"-6,306.00","1,008,517.24"
,22/10/2022,Transaction,,SHOP SALE,,EastX  Saver ****7829,-100,"1,008,417.24"
,22/10/2022,Transaction,,Holt's,,EastX ****2310,-73.2,"1,008,344.04"
,22/10/2022,Transaction,,John Pelly,,EastX  Saver ****7829,-700,"1,007,644.04"
,22/10/2022,Receipt,12987,HH Sheikh Mohammed Al-Sharqi,,-Split-,"86,000.00","1,093,644.04"
,25/10/2022,Receipt,13004,Online Sale,,Sales of Product Income:UK Sales,372,"1,094,016.04"
,25/10/2022,Transaction,,Online Sale,,Apple Account,-13.52,"1,094,002.52"
,25/10/2022,Receipt,13006,Maple Ranch,,-Split-,250,"1,094,252.52"
,25/10/2022,Receipt,13001,Online Sale,,-Split-,725,"1,094,977.52"
,25/10/2022,Receipt,13002,Online Sale,,Sales of Product Income:Non UK Sales,459.17,"1,095,436.69"
,25/10/2022,Receipt,12999,Online Sale,,Sales of Product Income:Non UK Sales,89,"1,095,525.69"
,25/10/2022,Receipt,12998,Online Sale,,Sales of Product Income:Non UK Sales,103.33,"1,095,629.02"
,25/10/2022,Receipt,13005,SHOP SALE,,Sales of Product Income:UK Sales,75,"1,095,704.02"
,25/10/2022,Transaction,,Online Sale,,EastX ****2310,-366.59,"1,095,337.43"
,25/10/2022,Transaction,,Online Sale,,Apple Account,-1.65,"1,095,335.78"
,25/10/2022,Transaction,,Online Sale,,Apple Account,-8.1,"1,095,327.68"
,25/10/2022,Transaction,,Online Sale,,EastX ****2310,-445.65,"1,094,882.03"
,25/10/2022,Transaction,,Morten Kristoffer Kjus,,EastX Bank,-104,"1,094,778.03"
,25/10/2022,Transaction,,Online Sale,,Apple Account,-2.78,"1,094,775.25"
,25/10/2022,Transaction,,Online Sale,,Apple Account,-10.35,"1,094,764.90"
,25/10/2022,Transaction,,Online Sale,,Apple Account,-5.41,"1,094,759.49"
,25/10/2022,Transaction,,Online Sale,,EastX ****2310,-264.4,"1,094,495.09"
,25/10/2022,Transaction,,Darach Albannach limited,,EastX Bank,"-3,722.40","1,090,772.69"
,25/10/2022,Transaction,,Online Sale,,EastX ****2310,-101.68,"1,090,671.01"
,25/10/2022,Transaction,,Online Sale,,EastX ****2310,-714.65,"1,089,956.36"
,25/10/2022,Transaction,,Online Sale,,EastX ****2310,-86.22,"1,089,870.14"
,25/10/2022,Receipt,13000,Online Sale,,Sales of Product Income:Non UK Sales,272.5,"1,090,142.64"
,26/10/2022,Receipt,13011,Lee Butler Gun & Rifle Makers,,-Split-,132,"1,090,274.64"
,26/10/2022,Receipt,13007,David Austin,,-Split-,30,"1,090,304.64"
,26/10/2022,Transaction,,David Austin,,-Split-,,"1,090,304.64"
,26/10/2022,Debit Memo,13008,David Austin,,-Split-,-12,"1,090,292.64"
,26/10/2022,Transaction,,HH Sheikh Mohammed Al-Sharqi,,Apple Account,-12,"1,090,280.64"
,26/10/2022,Transaction,,HH Sheikh Mohammed Al-Sharqi,,EastX Bank,"-99,988.00","990,292.64"
,26/10/2022,Transaction,,Chip Mahan,,EastX Bank,"-29,070.00","961,222.64"
,27/10/2022,Receipt,13014,Online Sale,,Sales of Product Income:Non UK Sales,60,"961,282.64"
,27/10/2022,Transaction,,Online Sale,,EastX ****2310,-435.29,"960,847.35"
,27/10/2022,Receipt,13013,Online Sale,,-Split-,52,"960,899.35"
,27/10/2022,Receipt,13015,Online Sale,,Sales of Product Income:Non UK Sales,155.83,"961,055.18"
,27/10/2022,Receipt,13016,Online Sale,,Sales of Product Income:Non UK Sales,239,"961,294.18"
,27/10/2022,Transaction,,Online Sale,,EastX ****2310,-50.29,"961,243.89"
,27/10/2022,Transaction,,Online Sale,,EastX ****2310,-151.11,"961,092.78"
,27/10/2022,Transaction,,Online Sale,,EastX ****2310,-58.06,"961,034.72"
,27/10/2022,Transaction,,Online Sale,,Apple Account,-1.71,"961,033.01"
,27/10/2022,Transaction,,Online Sale,,EastX ****2310,-231.87,"960,801.14"
,27/10/2022,Transaction,,Online Sale,,Apple Account,-1.94,"960,799.20"
,27/10/2022,Transaction,,Online Sale,,Apple Account,-7.13,"960,792.07"
,27/10/2022,Transaction,,SHOP SALE,,EastX  Saver ****7829,-180,"960,612.07"
,27/10/2022,Transaction,,Online Sale,,Apple Account,-6.38,"960,605.69"
,27/10/2022,Transaction,,Online Sale,,Apple Account,-4.72,"960,600.97"
,27/10/2022,Receipt,13012,Online Sale,,Sales of Product Income:Non UK Sales,441.67,"961,042.64"
,28/10/2022,Receipt,13029,HH Sheikh Mohammed Al-Sharqi:.577 RB set of 8 18809,,Orders in Hand/Deferred Income,"30,000.00","991,042.64"
,28/10/2022,Transaction,,Online Sale,,Apple Account,-1.66,"991,040.98"
,28/10/2022,Receipt,13020,Online Sale,,Sales of Product Income:UK Sales,257,"991,297.98"
,28/10/2022,Receipt,13025,HH Sheikh Mohammed Al-Sharqi:.416 RB set of 8 18805,,Orders in Hand/Deferred Income,"30,000.00","1,021,297.98"
,28/10/2022,Receipt,13019,Online Sale,,Sales of Product Income:UK Sales,257,"1,021,554.98"
,28/10/2022,Receipt,13030,HH Sheikh Mohammed Al-Sharqi:.600 RB set of 8,,Orders in Hand/Deferred Income,"30,000.00","1,051,554.98"
,28/10/2022,Receipt,13028,HH Sheikh Mohammed Al-Sharqi:500 RB set of 8 18808,,Orders in Hand/Deferred Income,"30,000.00","1,081,554.98"
,28/10/2022,Receipt,13027,HH Sheikh Mohammed Al-Sharqi:470 RB set of 8 18807,,Orders in Hand/Deferred Income,"30,000.00","1,111,554.98"
,28/10/2022,Receipt,13021,Armurerie Nouvelle,,-Split-,"84,000.00","1,195,554.98"
,28/10/2022,Receipt,13022,HH Sheikh Mohammed Al-Sharqi:The British 6,,Orders in Hand/Deferred Income,"20,000.00","1,215,554.98"
,28/10/2022,Receipt,13024,HH Sheikh Mohammed Al-Sharqi:.350 RB set of 8 18804,,Orders in Hand/Deferred Income,"30,000.00","1,245,554.98"
,28/10/2022,Receipt,13031,SHOP SALE,,Sales of Product Income:UK Sales,100,"1,245,654.98"
,28/10/2022,Receipt,13026,HH Sheikh Mohammed Al-Sharqi:450 RB set of 8 18806,,Orders in Hand/Deferred Income,"30,000.00","1,275,654.98"
,28/10/2022,Receipt,13018,Online Sale,,Sales of Product Income:UK Sales,104,"1,275,758.98"
,28/10/2022,Receipt,12986,Armurerie Collard,,Sales of Product Income:Non UK Sales,"5,600.00","1,281,358.98"
,28/10/2022,Receipt,13033,Steven F Clark,,Sales of Product Income:Sales,"13,231.00","1,294,589.98"
,28/10/2022,Receipt,13032,Outdoor Outfitters,,-Split-,"180,182.40","1,474,772.38"
,28/10/2022,Transaction,,Online Sale,,Apple Account,-3.8,"1,474,768.58"
,28/10/2022,Transaction,,Tarek Mahmoud,,EastX Bank,"-19,575.00","1,455,193.58"
,28/10/2022,Transaction,,Online Sale,,Apple Account,-3.8,"1,455,189.78"
,28/10/2022,Receipt,13023,HH Sheikh Mohammed Al-Sharqi:.275 RB set of 8 18803,,Orders in Hand/Deferred Income,"30,000.00","1,485,189.78"
,29/10/2022,Receipt,13034,SHOP SALE,,Sales of Product Income:UK Sales,200,"1,485,389.78"
,29/10/2022,Receipt,12996,Tony,,Sales of Product Income:UK Sales,39,"1,485,428.78"
,29/10/2022,Receipt,12993,Northwood USA 1,,-Split-,"43,310.00","1,528,738.78"
,29/10/2022,Receipt,12994,Krister Karki,,-Split-,"15,968.00","1,544,706.78"
,29/10/2022,Receipt,12995,SHOP SALE,,Sales of Product Income:UK Sales,90,"1,544,796.78"
,29/10/2022,Transaction,,SHOP SALE,,EastX  Saver ****7829,-90,"1,544,706.78"
,29/10/2022,Receipt,12966,Theo  Senekal,,-Split-,"22,660.00","1,567,366.78"
,29/10/2022,Transaction,,Mike Botha,,EastX Bank,"-1,549.68","1,565,817.10"
,29/10/2022,Transaction,,Tony,,EastX  Saver ****7829,-39,"1,565,778.10"
,29/10/2022,Transaction,,Renita Abraham,,EastX Bank,"-20,900.00","1,544,878.10"
,29/10/2022,Transaction,,David Austin,,EastX Bank,"-6,739.40","1,538,138.70"
,29/10/2022,Receipt,13017,Northwood Group UK,,Sales of Product Income:Sales,"1,080.00","1,539,218.70"
,30/10/2022,Receipt,13037,Online Sale,,Sales of Product Income:Non UK Sales,244.17,"1,539,462.87"
,31/10/2022,Receipt,13039,Online Sale,,Sales of Product Income:Non UK Sales,122.5,"1,539,585.37"
,31/10/2022,Receipt,13040,SHOP SALE,,Sales of Product Income:Non UK Sales,0,"1,539,585.37"
,31/10/2022,Receipt,13038,Online Sale,,Sales of Product Income:Non UK Sales,200,"1,539,785.37"
,31/10/2022,Transaction,,Online Sale,,Apple Account,-7.28,"1,539,778.09"
,31/10/2022,Transaction,,Online Sale,,Apple Account,-3,"1,539,775.09"
,31/10/2022,Transaction,,Northwood USA 1,,Apple Account,"-7,749.77","1,532,025.32"
,31/10/2022,Transaction,,Online Sale,,Apple Account,-3.75,"1,532,021.57"
,1/11/2022,Transaction,,Online Sale,,EastX ****2310,-102.34,"1,531,919.23"
,1/11/2022,Transaction,,Online Sale,,EastX ****2310,-253.2,"1,531,666.03"
,1/11/2022,Receipt,13041,Northwood Group GMBH,,-Split-,431.08,"1,532,097.11"
,1/11/2022,Transaction,,Online Sale,,EastX ****2310,-253.2,"1,531,843.91"
,1/11/2022,Transaction,,Online Sale,,EastX ****2310,-118.75,"1,531,725.16"
,2/11/2022,Receipt,13043,SHOP SALE,,Sales of Product Income:UK Sales,40,"1,531,765.16"
,2/11/2022,Transaction,,SHOP SALE,,EastX  Saver ****7829,-40,"1,531,725.16"
,2/11/2022,Receipt,13044,James Walton,,Orders in Hand/Deferred Income,"6,000.00","1,537,725.16"
,3/11/2022,Receipt,13064,SHOP SALE,,Sales of Product Income:Sales,75,"1,537,800.16"
,3/11/2022,Receipt,13048,Online Sale,,Sales of Product Income:UK Sales,62,"1,537,862.16"
,3/11/2022,Receipt,13049,Jacob Stockman,,-Split-,299,"1,538,161.16"
,3/11/2022,Transaction,,SHOP SALE,,EastX  Saver ****7829,-100,"1,538,061.16"
,3/11/2022,Transaction,,Online Sale,,EastX ****2310,-197,"1,537,864.16"
,3/11/2022,Transaction,,Online Sale,,EastX ****2310,-236.89,"1,537,627.27"
,3/11/2022,Transaction,,Armurerie Richard,,EastX Bank,"-34,104.00","1,503,523.27"
,3/11/2022,Transaction,,James Walton,,EastX Bank,"-6,000.00","1,497,523.27"
,3/11/2022,Transaction,,Online Sale,,Apple Account,-1.07,"1,497,522.20"
,3/11/2022,Transaction,,SHOP SALE,,EastX  Saver ****7829,-45,"1,497,477.20"
,3/11/2022,Transaction,,SAS Hunting Club Consulting,,EastX Bank,-261.9,"1,497,215.30"
,3/11/2022,Transaction,,Online Sale,,EastX ****2310,-60.93,"1,497,154.37"
,3/11/2022,Transaction,,SHOP SALE,,EastX  Saver ****7829,-200,"1,496,954.37"
,4/11/2022,Ledger Entry,3330,,Dividend received from TEG,-Split-,"24,800.00","1,521,754.37"
,5/11/2022,Receipt,13051,The Traditional English cases Ltd,,-Split-,237.5,"1,521,991.87"
,8/11/2022,Receipt,13052,Online Sale,,Sales of Product Income:Non UK Sales,228.33,"1,522,220.20"
,8/11/2022,Transaction,,Online Sale,,EastX ****2310,-105.79,"1,522,114.41"
,8/11/2022,Receipt,13054,Tim Spicer,,Sales of Product Income:UK Sales,387,"1,522,501.41"
,8/11/2022,Receipt,13053,Online Sale,,Sales of Product Income:Non UK Sales,107.5,"1,522,608.91"
,8/11/2022,Transaction,,Russell Gordy,,EastX Bank,"-52,500.00","1,470,108.91"
,8/11/2022,Transaction,,Brian Groat,,EastX Bank,"-2,844.00","1,467,264.91"
,8/11/2022,Transaction,,Tim Spicer,,EastX  Saver ****7829,-387,"1,466,877.91"
,8/11/2022,Transaction,,Online Sale,,EastX ****2310,-221.51,"1,466,656.40"
,8/11/2022,Transaction,,Online Sale,,Apple Account,-6.82,"1,466,649.58"
,8/11/2022,Transaction,,Online Sale,,Apple Account,-1.71,"1,466,647.87"
,9/11/2022,Receipt,12821,Northwood Group Kft,,-Split-,"12,000.00","1,478,647.87"
,9/11/2022,Transaction,,Theo  Senekal,,EastX Bank,"-11,330.00","1,467,317.87"
,9/11/2022,Receipt,13055,Northwood USA 1,,Sales of Product Income:Non UK Sales,"2,964.00","1,470,281.87"
,10/11/2022,Transaction,,Online Sale,,EastX ****2310,-221.65,"1,470,060.22"
,10/11/2022,Transaction,,Online Sale,,Apple Account,-1.07,"1,470,059.15"
,10/11/2022,Receipt,13058,Online Sale,,Sales of Product Income:Non UK Sales,225,"1,470,284.15"
,10/11/2022,Receipt,13060,Alfie Southwell,,Sales of Product Income:Sales,250,"1,470,534.15"
,10/11/2022,Transaction,,SHOP SALE,,EastX  Saver ****7829,-400,"1,470,134.15"
,10/11/2022,Transaction,,Online Sale,,EastX ****2310,-332.08,"1,469,802.07"
,10/11/2022,Transaction,,Online Sale,,Apple Account,-4.92,"1,469,797.15"
,10/11/2022,Transaction,,Online Sale,,EastX ****2310,-60.93,"1,469,736.22"
,10/11/2022,Transaction,,Online Sale,,Apple Account,-3.35,"1,469,732.87"
,10/11/2022,Transaction,,Alfie Southwell,,EastX  Saver ****7829,-250,"1,469,482.87"
,10/11/2022,Receipt,13153,SHOP SALE,,Sales of Product Income:Sales,400,"1,469,882.87"
,10/11/2022,Receipt,13057,Online Sale,,Sales of Product Income:UK Sales,62,"1,469,944.87"
,10/11/2022,Receipt,13059,Online Sale,,Sales of Product Income:UK Sales,337,"1,470,281.87"
,11/11/2022,Transaction,,Online Sale,,Apple Account,-0.78,"1,470,281.09"
,11/11/2022,Transaction,,Online Sale,,EastX ****2310,-158.55,"1,470,122.54"
,11/11/2022,Transaction,,Online Sale,,Apple Account,-2.45,"1,470,120.09"
,11/11/2022,Receipt,13062,Online Sale,,Sales of Product Income:Non UK Sales,41.67,"1,470,161.76"
,11/11/2022,Transaction,,Online Sale,,EastX ****2310,-40.89,"1,470,120.87"
,11/11/2022,Receipt,13063,Online Sale,,Sales of Product Income:UK Sales,161,"1,470,281.87"
,11/11/2022,Receipt,13061,SHOP SALE,,Sales of Product Income:UK Sales,45,"1,470,326.87"
,12/11/2022,Receipt,13066,Corey Knowlton,,Orders in Hand/Deferred Income,"15,686.39","1,486,013.26"
,12/11/2022,Receipt,13068,SHOP SALE,,Sales of Product Income:Sales,600,"1,486,613.26"
,12/11/2022,Receipt,13065,SHOP SALE,,Sales of Product Income:Sales,250,"1,486,863.26"
,12/11/2022,Receipt,13067,Online Sale,,Sales of Product Income:UK Sales,89,"1,486,952.26"
,12/11/2022,Receipt,13069,Gut Grambow SonySports GmbH,,-Split-,"2,534.00","1,489,486.26"
,12/11/2022,Transaction,,SHOP SALE,,Apple Account,-152.66,"1,489,333.60"
,12/11/2022,Transaction,,Online Sale,,Apple Account,-1.45,"1,489,332.15"
,12/11/2022,Transaction,,Online Sale,,EastX ****2310,-87.55,"1,489,244.60"
,12/11/2022,Transaction,,SHOP SALE,,EastX  Saver ****7829,-250,"1,488,994.60"
,12/11/2022,Transaction,,Lee Butler Gun & Rifle Makers,,EastX Bank,-132,"1,488,862.60"
,12/11/2022,Transaction,,SHOP SALE,,EastX  Saver ****7829,-75,"1,488,787.60"
,15/11/2022,Receipt,13071,Online Sale,,Sales of Product Income:Non UK Sales,202.5,"1,488,990.10"
,15/11/2022,Transaction,,Online Sale,,Apple Account,-8.73,"1,488,981.37"
,15/11/2022,Receipt,13070,Northwood Group Kft,,Sales of Product Income:Non UK Sales,851.93,"1,489,833.30"
,15/11/2022,Receipt,13075,Online Sale,,Sales of Product Income:Non UK Sales,235.83,"1,490,069.13"
,15/11/2022,Receipt,13072,Online Sale,,Sales of Product Income:Non UK Sales,294.17,"1,490,363.30"
,15/11/2022,Receipt,13074,Online Sale,,Sales of Product Income:Non UK Sales,355,"1,490,718.30"
,15/11/2022,Receipt,13078,SHOP SALE,,Sales of Product Income:UK Sales,49,"1,490,767.30"
,15/11/2022,Receipt,13077,Andrew Parsons,,Sales of Product Income:Sales,667,"1,491,434.30"
,15/11/2022,Receipt,13081,Online Sale,,Sales of Product Income:Non UK Sales,91.67,"1,491,525.97"
,15/11/2022,Receipt,13082,Online Sale,,Sales of Product Income:Non UK Sales,115,"1,491,640.97"
,15/11/2022,Receipt,13076,Outdoor Outfitters,,-Split-,100,"1,491,740.97"
,15/11/2022,Debit Memo,13080,Russel Bleiler,,Sales of Product Income:Non UK Sales,-240,"1,491,500.97"
,15/11/2022,Transaction,,Online Sale,,EastX ****2310,-90.19,"1,491,410.78"
,15/11/2022,Transaction,,Online Sale,,EastX ****2310,-285.44,"1,491,125.34"
,15/11/2022,Transaction,,Online Sale,,EastX ****2310,-228.79,"1,490,896.55"
,15/11/2022,Transaction,,Online Sale,,Apple Account,-6.07,"1,490,890.48"
,15/11/2022,Transaction,,SHOP SALE,,EastX ****2310,-447.34,"1,490,443.14"
,15/11/2022,Transaction,,Online Sale,,EastX ****2310,-196.43,"1,490,246.71"
,15/11/2022,Transaction,,Online Sale,,EastX ****2310,-59.95,"1,490,186.76"
,15/11/2022,Transaction,,Online Sale,,Apple Account,-7.04,"1,490,179.72"
,15/11/2022,Transaction,,SHOP SALE,,EastX  Saver ****7829,-25,"1,490,154.72"
,15/11/2022,Transaction,,Online Sale,,EastX ****2310,-349.83,"1,489,804.89"
,15/11/2022,Transaction,,Russel Bleiler,,-Split-,,"1,489,804.89"
,15/11/2022,Transaction,,Online Sale,,Apple Account,-5.17,"1,489,799.72"
,15/11/2022,Transaction,,Online Sale,,Apple Account,-3.54,"1,489,796.18"
,15/11/2022,Transaction,,Online Sale,,Apple Account,-1.48,"1,489,794.70"
,15/11/2022,Transaction,,Online Sale,,EastX ****2310,-111.46,"1,489,683.24"
,15/11/2022,Transaction,,Online Sale,,Apple Account,-1.05,"1,489,682.19"
,15/11/2022,Transaction,,Andrew Parsons,,EastX  Saver ****7829,-667,"1,489,015.19"
,15/11/2022,Transaction,,SHOP SALE,,EastX  Saver ****7829,-49,"1,488,966.19"
,15/11/2022,Receipt,13073,Online Sale,,Sales of Product Income:UK Sales,61,"1,489,027.19"
,16/11/2022,Receipt,13084,Online Sale,,-Split-,32,"1,489,059.19"
,16/11/2022,Receipt,13085,SHOP SALE,,Sales of Product Income:UK Sales,25,"1,489,084.19"
,16/11/2022,Receipt,13083,Online Sale,,Sales of Product Income:Non UK Sales,107.5,"1,489,191.69"
,16/11/2022,Transaction,,Online Sale,,Apple Account,-1.71,"1,489,189.98"
,16/11/2022,Transaction,,Online Sale,,Apple Account,-0.65,"1,489,189.33"
,16/11/2022,Transaction,,Corey Knowlton,,EastX Bank,"-25,686.39","1,463,502.94"
,16/11/2022,Transaction,,Online Sale,,EastX ****2310,-105.79,"1,463,397.15"
,16/11/2022,Transaction,,Online Sale,,EastX ****2310,-31.35,"1,463,365.80"
,17/11/2022,Receipt,13134,Sheikh Salman Bin Ebrahim Al-Khalifa,,Orders in Hand/Deferred Income,"8,000.00","1,471,365.80"
,17/11/2022,Transaction,,SHOP SALE,,EastX  Saver ****7829,-100,"1,471,265.80"
,17/11/2022,Receipt,13152,SHOP SALE,,Sales of Product Income:UK Sales,100,"1,471,365.80"
,18/11/2022,Receipt,13090,Online Sale,,-Split-,32,"1,471,397.80"
,18/11/2022,Transaction,,SHOP SALE,,EastX  Saver ****7829,-199,"1,471,198.80"
,18/11/2022,Receipt,13089,Maximilian Carl R Kirchhoff,,-Split-,"1,179.00","1,472,377.80"
,18/11/2022,Receipt,13093,Online Sale,,Sales of Product Income:Non UK Sales,129.17,"1,472,506.97"
,18/11/2022,Receipt,13092,Online Sale,,Sales of Product Income:UK Sales,222,"1,472,728.97"
,18/11/2022,Transaction,,Maximilian Carl R Kirchhoff,,EastX  Saver ****7829,"-1,179.00","1,471,549.97"
,18/11/2022,Transaction,,Online Sale,,EastX ****2310,-218.69,"1,471,331.28"
,18/11/2022,Transaction,,Online Sale,,EastX ****2310,-31.35,"1,471,299.93"
,18/11/2022,Transaction,,Online Sale,,Apple Account,-2.01,"1,471,297.92"
,18/11/2022,Transaction,,Online Sale,,Apple Account,-0.65,"1,471,297.27"
,18/11/2022,Transaction,,Online Sale,,EastX ****2310,-31.35,"1,471,265.92"
,18/11/2022,Transaction,,Online Sale,,Apple Account,-3.31,"1,471,262.61"
,18/11/2022,Transaction,,Online Sale,,EastX ****2310,-127.16,"1,471,135.45"
,18/11/2022,Transaction,,Online Sale,,Apple Account,-0.65,"1,471,134.80"
,18/11/2022,Receipt,13091,Online Sale,,-Split-,32,"1,471,166.80"
,19/11/2022,Receipt,13094,Paul Harter,,-Split-,675,"1,471,841.80"
,19/11/2022,Receipt,13087,Ifzaal  Musa,,Sales of Product Income:Non UK Sales,"2,000.00","1,473,841.80"
,19/11/2022,Transaction,,Paul Harter,,EastX  Saver ****7829,-675,"1,473,166.80"
,19/11/2022,Transaction,,SHOP SALE,,EastX  Saver ****7829,-60,"1,473,106.80"
,19/11/2022,Receipt,13088,SHOP SALE,,-Split-,199,"1,473,305.80"
,22/11/2022,Receipt,13095,Online Sale,,Sales of Product Income:Non UK Sales,225.42,"1,473,531.22"
,22/11/2022,Transaction,,HH Sheikh Mohammed Al-Sharqi,,Apple Account,-12,"1,473,519.22"
,22/11/2022,Receipt,13099,Online Sale,,Sales of Product Income:UK Sales,187,"1,473,706.22"
,22/11/2022,Receipt,13097,Online Sale,,Sales of Product Income:Non UK Sales,89.17,"1,473,795.39"
,22/11/2022,Receipt,13098,SHOP SALE,,Sales of Product Income:Non UK Sales,60,"1,473,855.39"
,22/11/2022,Receipt,13096,Online Sale,,Sales of Product Income:Non UK Sales,195.83,"1,474,051.22"
,22/11/2022,Transaction,,Online Sale,,EastX ****2310,-184.18,"1,473,867.04"
,22/11/2022,Transaction,,Online Sale,,Apple Account,-2.82,"1,473,864.22"
,22/11/2022,Transaction,,Online Sale,,EastX ****2310,-86.38,"1,473,777.84"
,22/11/2022,Transaction,,Online Sale,,Apple Account,-2.79,"1,473,775.05"
,22/11/2022,Transaction,,Online Sale,,EastX ****2310,-189.95,"1,473,585.10"
,22/11/2022,Transaction,,HH Sheikh Mohammed Al-Sharqi,,EastX Bank,"-99,988.00","1,373,597.10"
,22/11/2022,Transaction,,Online Sale,,Apple Account,-5.88,"1,373,591.22"
,22/11/2022,Transaction,,Online Sale,,Apple Account,-3.36,"1,373,587.86"
,22/11/2022,Transaction,,SHOP SALE,,EastX  Saver ****7829,-185,"1,373,402.86"
,22/11/2022,Transaction,,Online Sale,,EastX ****2310,-222.06,"1,373,180.80"
,22/11/2022,Transaction,,Northwood Group Kft,,EastX Bank,"-1,663.00","1,371,517.80"
,22/11/2022,Receipt,13100,SHOP SALE,,-Split-,185,"1,371,702.80"
,23/11/2022,Receipt,13102,Online Sale,,Sales of Product Income:UK Sales,307,"1,372,009.80"
,23/11/2022,Receipt,13104,John Shields,,Sales of Product Income:UK Sales,130,"1,372,139.80"
,23/11/2022,Receipt,13101,Online Sale,,Sales of Product Income:Non UK Sales,125,"1,372,264.80"
,23/11/2022,Transaction,,Online Sale,,EastX ****2310,-121.17,"1,372,143.63"
,23/11/2022,Transaction,,Online Sale,,EastX ****2310,-302.5,"1,371,841.13"
,23/11/2022,Transaction,,Online Sale,,Apple Account,-4.5,"1,371,836.63"
,23/11/2022,Transaction,,Online Sale,,Apple Account,-3.83,"1,371,832.80"
,24/11/2022,Receipt,13106,David Modesett,,-Split-,"38,910.00","1,410,742.80"
,24/11/2022,Receipt,13108,Armurerie Nouvelle,,Sales of Product Income:Non UK Sales,"4,089.60","1,414,832.40"
,24/11/2022,Receipt,13105,Davis Peterson,,-Split-,"5,700.00","1,420,532.40"
,24/11/2022,Receipt,13107,David Modesett,,-Split-,"38,910.00","1,459,442.40"
,25/11/2022,Receipt,13114,SHOP SALE,,Sales of Product Income:UK Sales,25,"1,459,467.40"
,25/11/2022,Receipt,13115,SHOP SALE,,Sales of Product Income:UK Sales,79.2,"1,459,546.60"
,25/11/2022,Receipt,13113,Armurerie Collard,,-Split-,270,"1,459,816.60"
,25/11/2022,Receipt,13112,Online Sale,,Sales of Product Income:UK Sales,170,"1,459,986.60"
,25/11/2022,Receipt,13110,Diego Antunes Brito,,Sales of Product Income:Non UK Sales,18.62,"1,460,005.22"
,25/11/2022,Transaction,,Maple Ranch,,EastX  Saver ****7829,-250,"1,459,755.22"
,25/11/2022,Receipt,13109,Online Sale,,Sales of Product Income:Non UK Sales,115,"1,459,870.22"
,25/11/2022,Transaction,,Online Sale,,Apple Account,-2.58,"1,459,867.64"
,25/11/2022,Transaction,,SHOP SALE,,EastX  Saver ****7829,-79.2,"1,459,788.44"
,25/11/2022,Transaction,,SHOP SALE,,EastX  Saver ****7829,-25,"1,459,763.44"
,25/11/2022,Transaction,,Online Sale,,Apple Account,-0.54,"1,459,762.90"
,25/11/2022,Receipt,13111,JAFI,,Sales of Product Income:Non UK Sales,50,"1,459,812.90"
,26/11/2022,Receipt,13129,SHOP SALE,,Sales of Product Income:UK Sales,180,"1,459,992.90"
,26/11/2022,Receipt,13130,SHOP SALE,,Sales of Product Income:UK Sales,35,"1,460,027.90"
,26/11/2022,Transaction,,SHOP SALE,,EastX  Saver ****7829,-70,"1,459,957.90"
,26/11/2022,Transaction,,SHOP SALE,,EastX  Saver ****7829,-180,"1,459,777.90"
,26/11/2022,Receipt,13151,SHOP SALE,,Sales of Product Income:UK Sales,70,"1,459,847.90"
,29/11/2022,Receipt,13120,Online Sale,,Sales of Product Income:Non UK Sales,115,"1,459,962.90"
,29/11/2022,Transaction,,Online Sale,,Apple Account,-0.65,"1,459,962.25"
,29/11/2022,Receipt,13122,Online Sale,,-Split-,32,"1,459,994.25"
,29/11/2022,Receipt,13119,Online Sale,,-Split-,40,"1,460,034.25"
,29/11/2022,Receipt,13117,Russell Gordy,,Sales of Product Income:Non UK Sales,"5,957.00","1,465,991.25"
,29/11/2022,Receipt,13124,Online Sale,,Sales of Product Income:Non UK Sales,135.83,"1,466,127.08"
,29/11/2022,Receipt,13121,Online Sale,,Sales of Product Income:UK Sales,170,"1,466,297.08"
,29/11/2022,Receipt,13123,Online Sale,,Sales of Product Income:Non UK Sales,425,"1,466,722.08"
,29/11/2022,Transaction,,Online Sale,,Apple Account,-0.76,"1,466,721.32"
,29/11/2022,Transaction,,Online Sale,,Apple Account,-0.65,"1,466,720.67"
,29/11/2022,Transaction,,Online Sale,,EastX ****2310,-111.46,"1,466,609.21"
,29/11/2022,Transaction,,Online Sale,,Apple Account,-2.58,"1,466,606.63"
,29/11/2022,Transaction,,Online Sale,,EastX ****2310,-167.42,"1,466,439.21"
,29/11/2022,Transaction,,Online Sale,,Apple Account,-3.54,"1,466,435.67"
,29/11/2022,Transaction,,Online Sale,,Apple Account,-4.14,"1,466,431.53"
,29/11/2022,Transaction,,Online Sale,,Apple Account,-6.15,"1,466,425.38"
,29/11/2022,Receipt,13118,Online Sale,,-Split-,32,"1,466,457.38"
,30/11/2022,Receipt,13131,James Walton,,Sales of Product Income:UK Sales,"5,162.40","1,471,619.78"
,30/11/2022,Transaction,,Hartmann & Weiss GmbH,,EastX Bank,-545.3,"1,471,074.48"
,30/11/2022,Receipt,13144,Outdoor Outfitters,,-Split-,"135,250.40","1,606,324.88"
,30/11/2022,Receipt,13143,Thomas Hill,,Sales of Product Income:Non UK Sales,"44,740.00","1,651,064.88"
,30/11/2022,Receipt,13145,David Modesett,,-Split-,"70,000.00","1,721,064.88"
,30/11/2022,Receipt,13142,Tarek Mahmoud,,Sales of Product Income:UK Sales,"23,195.00","1,744,259.88"
,30/11/2022,Receipt,13116,Outdoor Outfitters,,Sales of Product Income:Non UK Sales,"28,000.00","1,772,259.88"
,30/11/2022,Receipt,13146,Mary,,-Split-,166.87,"1,772,426.75"
,30/11/2022,Receipt,13127,Online Sale,,Sales of Product Income:Non UK Sales,193.33,"1,772,620.08"
,30/11/2022,Receipt,13125,Online Sale,,-Split-,27,"1,772,647.08"
,30/11/2022,Receipt,13128,Online Sale,,Sales of Product Income:Non UK Sales,105.83,"1,772,752.91"
,30/11/2022,Receipt,13132,Online Sale,,Sales of Product Income:UK Sales,237,"1,772,989.91"
,30/11/2022,Receipt,13035,Northwood USA 1,,Sales of Product Income:Non UK Sales,0,"1,772,989.91"
,30/11/2022,Receipt,13045,David Austin,,-Split-,"12,982.00","1,785,971.91"
,30/11/2022,Transaction,,Online Sale,,Apple Account,-5.81,"1,785,966.10"
,30/11/2022,Transaction,,Online Sale,,Apple Account,-1.48,"1,785,964.62"
,30/11/2022,Transaction,,Davis Peterson,,EastX Bank,"-9,988.00","1,775,976.62"
,30/11/2022,Transaction,,Krister Karki,,EastX Bank,"-15,968.00","1,760,008.62"
,30/11/2022,Transaction,,Online Sale,,Apple Account,-3.52,"1,760,005.10"
,30/11/2022,Transaction,,Online Sale,,Apple Account,-3.27,"1,760,001.83"
,30/11/2022,Transaction,,Sheikh Salman Bin Ebrahim Al-Khalifa,,EastX Bank,"-8,000.00","1,752,001.83"
,30/11/2022,Transaction,,Online Sale,,Apple Account,-0.58,"1,752,001.25"
,30/11/2022,Transaction,,Northwood USA 1,,Apple Account,"-6,820.65","1,745,180.60"
,30/11/2022,Receipt,13126,Online Sale,,Sales of Product Income:Non UK Sales,91.67,"1,745,272.27"
,1/12/2022,Transaction,,Online Sale,,Apple Account,-3.18,"1,745,269.09"
,1/12/2022,Receipt,13138,David Austin,,-Split-,323,"1,745,592.09"
,1/12/2022,Transaction,,Online Sale,,EastX ****2310,-90.19,"1,745,501.90"
,1/12/2022,Transaction,,Online Sale,,EastX ****2310,-418.85,"1,745,083.05"
,1/12/2022,Transaction,,Online Sale,,EastX ****2310,-26.42,"1,745,056.63"
,1/12/2022,Transaction,,Online Sale,,Apple Account,-1.12,"1,745,055.51"
,1/12/2022,Transaction,,Online Sale,,EastX ****2310,-167.42,"1,744,888.09"
,1/12/2022,Transaction,,Davis Peterson,,Apple Account,-12,"1,744,876.09"
,1/12/2022,Transaction,,Online Sale,,EastX ****2310,-31.35,"1,744,844.74"
,1/12/2022,Receipt,13140,Nick Rudicle,,Sales of Product Income:Non UK Sales,275,"1,745,119.74"
,1/12/2022,Receipt,13139,Nelson Neto Junior,,Sales of Product Income:UK Sales,69,"1,745,188.74"
,1/12/2022,Transaction,,Online Sale,,EastX ****2310,-64.71,"1,745,124.03"
,1/12/2022,Transaction,,Online Sale,,EastX ****2310,-111.46,"1,745,012.57"
,1/12/2022,Transaction,,Online Sale,,EastX ****2310,-209.32,"1,744,803.25"
,1/12/2022,Receipt,13137,Gary Duffey,,-Split-,452,"1,745,255.25"
,1/12/2022,Receipt,13135,Online Sale,,Sales of Product Income:Non UK Sales,65.83,"1,745,321.08"
,1/12/2022,Transaction,,SHOP SALE,,EastX  Saver ****7829,-35,"1,745,286.08"
,1/12/2022,Receipt,13136,Online Sale,,Sales of Product Income:Non UK Sales,212.5,"1,745,498.58"
,1/12/2022,Transaction,,Online Sale,,EastX ****2310,-131.69,"1,745,366.89"
,2/12/2022,Transaction,,SHOP SALE,,EastX  Saver ****7829,-65,"1,745,301.89"
,2/12/2022,Transaction,,The Traditional English cases Ltd,,EastX Bank,-743.22,"1,744,558.67"
,2/12/2022,Transaction,,Online Sale,,EastX ****2310,-187.52,"1,744,371.15"
,2/12/2022,Transaction,,Online Sale,,EastX ****2310,-102.56,"1,744,268.59"
,2/12/2022,Transaction,,Online Sale,,EastX ****2310,-39.24,"1,744,229.35"
,2/12/2022,Transaction,,Online Sale,,EastX ****2310,-233.48,"1,743,995.87"
,2/12/2022,Transaction,,SHOP SALE,,EastX  Saver ****7829,-10,"1,743,985.87"
,2/12/2022,Transaction,,Northwood Group Norway AS,,EastX Bank,-858,"1,743,127.87"
,2/12/2022,Receipt,13147,SHOP SALE,,Sales of Product Income:UK Sales,65,"1,743,192.87"
,2/12/2022,Receipt,13148,Bob Phillips,,Orders in Hand/Deferred Income,"9,217.20","1,752,410.07"
,2/12/2022,Receipt,13149,SHOP SALE,,Sales of Product Income:UK Sales,10,"1,752,420.07"
,2/12/2022,Transaction,,Online Sale,,EastX ****2310,-31.35,"1,752,388.72"
,3/12/2022,Receipt,13150,Alfie Southwell,,Sales of Product Income:UK Sales,325,"1,752,713.72"
,3/12/2022,Transaction,,Alfie Southwell,,EastX  Saver ****7829,-325,"1,752,388.72"
,3/12/2022,Transaction,,Olivier Leclercq,,EastX  Saver ****7829,-185,"1,752,203.72"
,6/12/2022,Transaction,,Online Sale,,Apple Account,-24.2,"1,752,179.52"
,6/12/2022,Transaction,,Online Sale,,Apple Account,-1.49,"1,752,178.03"
,6/12/2022,Transaction,,Online Sale,,EastX ****2310,-158.55,"1,752,019.48"
,6/12/2022,Transaction,,Online Sale,,Apple Account,-2.02,"1,752,017.46"
,6/12/2022,Transaction,,Online Sale,,EastX ****2310,-90.51,"1,751,926.95"
,6/12/2022,Transaction,,Online Sale,,EastX ****2310,-127.98,"1,751,798.97"
,6/12/2022,Transaction,,Online Sale,,Apple Account,-0.86,"1,751,798.11"
,6/12/2022,Transaction,,David Austin,,EastX Bank,"-26,685.00","1,725,113.11"
,6/12/2022,Transaction,,Online Sale,,EastX ****2310,-803.3,"1,724,309.81"
,6/12/2022,Transaction,,Online Sale,,EastX ****2310,-127.16,"1,724,182.65"
,6/12/2022,Transaction,,Online Sale,,Apple Account,-2.45,"1,724,180.20"
,6/12/2022,Transaction,,Online Sale,,EastX ****2310,-46.14,"1,724,134.06"
,6/12/2022,Transaction,,Online Sale,,Apple Account,-2.01,"1,724,132.05"
,6/12/2022,Receipt,13161,Pablo Gonzalez,,-Split-,88.8,"1,724,220.85"
,6/12/2022,Receipt,13158,Online Sale,,Sales of Product Income:UK Sales,161,"1,724,381.85"
,6/12/2022,Receipt,13159,Online Sale,,Sales of Product Income:UK Sales,130,"1,724,511.85"
,6/12/2022,Receipt,13157,Online Sale,,Sales of Product Income:Non UK Sales,827.5,"1,725,339.35"
,6/12/2022,Receipt,13155,Online Sale,,Sales of Product Income:UK Sales,92,"1,725,431.35"
,6/12/2022,Receipt,13162,Olivier Leclercq,,-Split-,185,"1,725,616.35"
,6/12/2022,Receipt,13154,Online Sale,,-Split-,47,"1,725,663.35"
,6/12/2022,Receipt,13156,Online Sale,,Sales of Product Income:Non UK Sales,129.17,"1,725,792.52"
,7/12/2022,Transaction,,Online Sale,,Apple Account,-1.12,"1,725,791.40"
,7/12/2022,Transaction,,Online Sale,,EastX ****2310,-64.71,"1,725,726.69"
,7/12/2022,Transaction,,Online Sale,,Apple Account,-1.07,"1,725,725.62"
,7/12/2022,Receipt,13163,Online Sale,,Sales of Product Income:Non UK Sales,65.83,"1,725,791.45"
,7/12/2022,Receipt,13165,Online Sale,,Sales of Product Income:UK Sales,62,"1,725,853.45"
,7/12/2022,Receipt,13164,Online Sale,,Sales of Product Income:Non UK Sales,130,"1,725,983.45"
,7/12/2022,Transaction,,Online Sale,,EastX ****2310,-60.93,"1,725,922.52"
,7/12/2022,Transaction,,Online Sale,,Apple Account,-3,"1,725,919.52"
,7/12/2022,Transaction,,Online Sale,,EastX ****2310,-127.98,"1,725,791.54"
,7/12/2022,Transaction,,Outdoor Outfitters,,EastX Bank,"-364,173.80","1,361,617.74"
,7/12/2022,Transaction,,Online Sale,,Apple Account,-2.02,"1,361,615.72"
,8/12/2022,Transaction,,Online Sale,,EastX ****2310,-186.15,"1,361,429.57"
,8/12/2022,Receipt,13166,Online Sale,,Sales of Product Income:Non UK Sales,135.83,"1,361,565.40"
,8/12/2022,Transaction,,Online Sale,,Apple Account,-2.85,"1,361,562.55"
,8/12/2022,Transaction,,Bob Phillips,,EastX ****2310,"-9,217.20","1,352,345.35"
,8/12/2022,Transaction,,Online Sale,,EastX ****2310,-131.69,"1,352,213.66"
,8/12/2022,Transaction,,Online Sale,,Apple Account,-4.14,"1,352,209.52"
,8/12/2022,Receipt,13204,Tommy Salmon,,Orders in Hand/Deferred Income,"13,450.00","1,365,659.52"
,8/12/2022,Receipt,13167,Online Sale,,Sales of Product Income:UK Sales,189,"1,365,848.52"
,9/12/2022,Transaction,,Online Sale,,Apple Account,-3.35,"1,365,845.17"
,9/12/2022,Receipt,13170,Online Sale,,Sales of Product Income:Non UK Sales,225,"1,366,070.17"
,9/12/2022,Transaction,,Northwood Group UK,,Apple Account,"-1,080.00","1,364,990.17"
,9/12/2022,Transaction,,Online Sale,,EastX ****2310,-221.65,"1,364,768.52"
,10/12/2022,Receipt,13173,Online Sale,,Sales of Product Income:Non UK Sales,212.5,"1,364,981.02"
,10/12/2022,Transaction,,Mary,,EastX  Saver ****7829,-166.87,"1,364,814.15"
,10/12/2022,Transaction,,David Modesett,,EastX Bank,"-147,820.00","1,216,994.15"
,10/12/2022,Transaction,,Online Sale,,Apple Account,-3.18,"1,216,990.97"
,10/12/2022,Transaction,,Sheikh Salman Bin Ebrahim Al-Khalifa,,EastX Bank,"-15,987.75","1,201,003.22"
,10/12/2022,Transaction,,Online Sale,,EastX ****2310,-209.32,"1,200,793.90"
,13/12/2022,Receipt,13177,Online Sale,,Sales of Product Income:UK Sales,102,"1,200,895.90"
,13/12/2022,Transaction,,Online Sale,,EastX ****2310,-100.37,"1,200,795.53"
,13/12/2022,Transaction,,Online Sale,,Apple Account,-3.54,"1,200,791.99"
,13/12/2022,Transaction,,Online Sale,,EastX ****2310,-111.46,"1,200,680.53"
,13/12/2022,Transaction,,Online Sale,,Apple Account,-1.63,"1,200,678.90"
,13/12/2022,Receipt,13176,Online Sale,,Sales of Product Income:Non UK Sales,115,"1,200,793.90"
,14/12/2022,Receipt,13178,Online Sale,,Sales of Product Income:Non UK Sales,45.83,"1,200,839.73"
,14/12/2022,Receipt,13179,Online Sale,,Sales of Product Income:Non UK Sales,65.83,"1,200,905.56"
,14/12/2022,Receipt,13180,David Austin,,-Split-,"7,224.00","1,208,129.56"
,14/12/2022,Transaction,,Online Sale,,EastX ****2310,-64.71,"1,208,064.85"
,14/12/2022,Transaction,,Armurerie Mallet,,Apple Account,-8,"1,208,056.85"
,14/12/2022,Transaction,,Online Sale,,Apple Account,-1.12,"1,208,055.73"
,14/12/2022,Transaction,,Online Sale,,Apple Account,-0.84,"1,208,054.89"
,14/12/2022,Transaction,,Armurerie Mallet,,EastX Bank,"-1,272.00","1,206,782.89"
,14/12/2022,Transaction,,Online Sale,,EastX ****2310,-44.99,"1,206,737.90"
,15/12/2022,Transaction,,Steven F Clark,,-Split-,,"1,206,737.90"
,15/12/2022,Transaction,,Online Sale,,EastX ****2310,-36.28,"1,206,701.62"
,15/12/2022,Transaction,,Online Sale,,EastX ****2310,-117.13,"1,206,584.49"
,15/12/2022,Transaction,,Online Sale,,Apple Account,-0.72,"1,206,583.77"
,15/12/2022,Transaction,,Online Sale,,Apple Account,-9.63,"1,206,574.14"
,15/12/2022,Transaction,,Online Sale,,Apple Account,-3.7,"1,206,570.44"
,15/12/2022,Transaction,,Hartmann & Weiss GmbH,,-Split-,,"1,206,570.44"
,15/12/2022,Transaction,,Online Sale,,EastX ****2310,-315.37,"1,206,255.07"
,15/12/2022,Debit Memo,13182,Steven F Clark,,Sales of Product Income:Sales,"-13,231.00","1,193,024.07"
,15/12/2022,Debit Memo,13187,Hartmann & Weiss GmbH,,Sales of Product Income:Non UK Sales,-8.5,"1,193,015.57"
,15/12/2022,Receipt,13183,Steven F Clark,,Sales of Product Income:Sales,"6,940.00","1,199,955.57"
,15/12/2022,Receipt,13188,Hartmann & Weiss GmbH,,Sales of Product Income:Non UK Sales,750,"1,200,705.57"
,15/12/2022,Receipt,13192,Online Sale,,Sales of Product Income:Non UK Sales,120.83,"1,200,826.40"
,15/12/2022,Receipt,13190,Francesco Corra,,Sales of Product Income:Non UK Sales,387.5,"1,201,213.90"
,15/12/2022,Receipt,13191,Online Sale,,Sales of Product Income:Non UK Sales,325,"1,201,538.90"
,15/12/2022,Receipt,13186,Krister Karki,,Sales of Product Income:Non UK Sales,850,"1,202,388.90"
,15/12/2022,Receipt,13184,Armurerie Collard,,Sales of Product Income:Non UK Sales,700,"1,203,088.90"
,15/12/2022,Receipt,13189,Francesco Lenzerini,,Sales of Product Income:Non UK Sales,475,"1,203,563.90"
,15/12/2022,Receipt,13185,Online Sale,,Sales of Product Income:UK Sales,37,"1,203,600.90"
,15/12/2022,Receipt,13169,Northwood USA 1,,-Split-,"124,718.00","1,328,318.90"
,16/12/2022,Transaction,,Online Sale,,EastX ****2310,-346.55,"1,327,972.35"
,16/12/2022,Transaction,,Online Sale,,Apple Account,-1.35,"1,327,971.00"
,16/12/2022,Transaction,,SHOP SALE,,EastX  Saver ****7829,-185,"1,327,786.00"
,16/12/2022,Transaction,,Online Sale,,Apple Account,-4.33,"1,327,781.67"
,16/12/2022,Transaction,,Online Sale,,EastX ****2310,-80.65,"1,327,701.02"
,16/12/2022,Transaction,,Online Sale,,Apple Account,-0.86,"1,327,700.16"
,16/12/2022,Transaction,,Online Sale,,EastX ****2310,-125.06,"1,327,575.10"
,16/12/2022,Transaction,,Online Sale,,Apple Account,-5.12,"1,327,569.98"
,16/12/2022,Transaction,,Online Sale,,Apple Account,-3.94,"1,327,566.04"
,16/12/2022,Transaction,,John Reed,,EastX  Saver ****7829,"-2,244.00","1,325,322.04"
,16/12/2022,Transaction,,Victor  Galea,,-Split-,,"1,325,322.04"
,16/12/2022,Transaction,,Online Sale,,EastX ****2310,-119.11,"1,325,202.93"
,16/12/2022,Transaction,,Online Sale,,EastX ****2310,-138.17,"1,325,064.76"
,16/12/2022,Transaction,,Online Sale,,EastX ****2310,-46.14,"1,325,018.62"
,16/12/2022,Transaction,,Online Sale,,Apple Account,-1.89,"1,325,016.73"
,16/12/2022,Receipt,13201,Online Sale,,Sales of Product Income:Non UK Sales,142.5,"1,325,159.23"
,16/12/2022,Receipt,13198,Online Sale,,Sales of Product Income:Non UK Sales,351.67,"1,325,510.90"
,16/12/2022,Receipt,13196,Online Sale,,Sales of Product Income:Non UK Sales,129,"1,325,639.90"
,16/12/2022,Receipt,13199,Online Sale,,-Split-,47,"1,325,686.90"
,16/12/2022,Receipt,13193,Victor  Galea,,-Split-,850,"1,326,536.90"
,16/12/2022,Receipt,13200,Online Sale,,Sales of Product Income:UK Sales,82,"1,326,618.90"
,16/12/2022,Receipt,13195,SHOP SALE,,Sales of Product Income:UK Sales,185,"1,326,803.90"
,16/12/2022,Receipt,13197,Online Sale,,Sales of Product Income:UK Sales,121,"1,326,924.90"
,17/12/2022,Transaction,,Steven F Clark,,EastX Bank,"-6,940.00","1,319,984.90"
,17/12/2022,Receipt,13171,David Austin,,-Split-,"9,600.00","1,329,584.90"
,17/12/2022,Receipt,13202,Online Sale,,Sales of Product Income:UK Sales,111,"1,329,695.90"
,17/12/2022,Transaction,,HH Sheikh Mohammed Al-Sharqi,,EastX Bank,"-186,000.00","1,143,695.90"
,17/12/2022,Transaction,,Online Sale,,EastX ****2310,-109.25,"1,143,586.65"
,17/12/2022,Transaction,,James Walton,,EastX Bank,"-5,162.40","1,138,424.25"
,17/12/2022,Receipt,13172,Thomas Ortmeier,,-Split-,125,"1,138,549.25"
,17/12/2022,Transaction,,Online Sale,,Apple Account,-1.75,"1,138,547.50"
,17/12/2022,Transaction,,HH Sheikh Mohammed Al-Sharqi,,Apple Account,-12,"1,138,535.50"
,17/12/2022,Transaction,,SHOP SALE,,EastX  Saver ****7829,-162,"1,138,373.50"
Total for Receivables,,,,,,,"£427,476.41  ",
Long Term Investment  (TEG),,,,,,,,
,Beginning Balance,,,,,,,"515,776.49"
Total for Long Term Investment  (TEG),,,,,,,,
PreTransactions,,,,,,,,
,Beginning Balance,,,,,,,"163,369.97"
,14/01/2022,Ledger Entry,2989,,magic safari overTransaction refund,-Split-,"-3,063.99","160,305.98"
,25/01/2022,Ledger Entry,2998,,Lothar Walther  overTransaction,-Split-,"3,001.70","163,307.68"
,31/01/2022,Ledger Entry,3018,,Marc Newton car insurance Revolution,-Split-,-109,"163,198.68"
,31/01/2022,Ledger Entry,3018,,Harper office Packing Material  Jan 2021,-Split-,-225.62,"162,973.06"
,31/01/2022,Ledger Entry,2996,,Lothar Walther overTransaction refund,-Split-,"-3,001.70","159,971.36"
,31/01/2022,Ledger Entry,3018,,Employee liability Insurance Jan 2021,-Split-,-776.3,"159,195.06"
,31/01/2022,Ledger Entry,3018,,Admiral  car insurance Jan 2021,-Split-,-100,"159,095.06"
,31/01/2022,Ledger Entry,3018,,West London Shooting School ground rent,-Split-,-143.4,"158,951.66"
,26/02/2022,Ledger Entry,3041,,Credit card receipt to be refunded in March,-Split-,-235,"158,716.66"
,28/02/2022,Ledger Entry,3046,,Marc Newton car insurance Revolution,-Split-,-109,"158,607.66"
,28/02/2022,Ledger Entry,3046,,Admiral  car insurance Feb 2021,-Split-,-100,"158,507.66"
,28/02/2022,Ledger Entry,3046,,Employee liability Insurance Feb 2021,-Split-,-776.3,"157,731.36"
,28/02/2022,Ledger Entry,3046,,Harper office Packing Material  Feb 2021,-Split-,-225.62,"157,505.74"
,28/02/2022,Ledger Entry,3046,,West London Shooting School ground rent,-Split-,-143.4,"157,362.34"
,31/03/2022,Ledger Entry,3072,,Marc Newton car insurance Revolution,-Split-,-109,"157,253.34"
,31/03/2022,Ledger Entry,3072,,West London Shooting School ground rent,-Split-,-143.4,"157,109.94"
,31/03/2022,Ledger Entry,3072,,Admiral  car insurance March 2021,-Split-,-100,"157,009.94"
,31/03/2022,Ledger Entry,3072,,Harper office Packing Material  Feb 2021,-Split-,-225.62,"156,784.32"
,31/03/2022,Ledger Entry,3070,,St John Ambulance refund,-Split-,-180,"156,604.32"
,31/03/2022,Ledger Entry,3070,,St John Ambulance refund,-Split-,-150,"156,454.32"
,31/03/2022,Ledger Entry,3072,,Employee liability Insurance March 2021,-Split-,-776.3,"155,678.02"
,7/4/2022,Ledger Entry,3078,,Natraj original Transaction,-Split-,395,"156,073.02"
,7/4/2022,Ledger Entry,3078,,Natraj Transaction refund,-Split-,-351.55,"155,721.47"
,13/04/2022,Expense,40/2920094,Willis Towers Watson,Marine Cargo Insurance - 448.00 Eur,Payables,386.2,"156,107.67"
,19/04/2022,Ledger Entry,3104,,Bank Giro credit  by Jamie unallocated,-Split-,-57.34,"156,050.33"
,21/04/2022,Ledger Entry,3422,,Courtney Boots exchange rate diff,-Split-,-152.49,"155,897.84"
,21/04/2022,Ledger Entry,3096,,refund from TCI paid by mistake,-Split-,-75.32,"155,822.52"
,21/04/2022,Ledger Entry,3096,,Transaction sent to TCI instead of XL insuranace,-Split-,77.39,"155,899.91"
,21/04/2022,Ledger Entry,3098,,Refund from Courtney boots for difference,-Split-,-569,"155,330.91"
,22/04/2022,Expense,7516,Gamefair,Cash Deposit - Space 3m frontage x 15m depth,Payables,"2,236.50","157,567.41"
,22/04/2022,Expense,7528,Gamefair,Additional space,Payables,"4,180.00","161,747.41"
,23/04/2022,Ledger Entry,3099,,Refund of Cash Deposit money received from Corey Knowlton paid by his company instead of personal account,-Split-,"21,296.69","183,044.10"
,23/04/2022,Ledger Entry,3099,,Cash Deposit money received from Corey Knowlton paid by his company instead of personal account,-Split-,"-21,296.69","161,747.41"
,26/04/2022,Expense,20753,TMC Ltd,Design & supply of 9m x 12m bespoke safari Style,Payables,"12,299.50","174,046.91"
,29/04/2022,Ledger Entry,3108,,Company house penalty Transaction to be reimbursed by Rodl,-Split-,750,"174,796.91"
,30/04/2022,Ledger Entry,3111,,Game fair cost released to P & L,-Split-,-534.71,"174,262.20"
,30/04/2022,Ledger Entry,3111,,Marine Cargo insurance released from preTransaction,-Split-,-32.18,"174,230.02"
,30/04/2022,Ledger Entry,3109,,Amex receipt not allocated,-Split-,-243,"173,987.02"
,30/04/2022,Ledger Entry,3111,,Harper office Packing Material  April 2021,-Split-,-225.62,"173,761.40"
,30/04/2022,Ledger Entry,3111,,West London Shooting School ground rent,-Split-,-143.4,"173,618.00"
,30/04/2022,Ledger Entry,3111,,Employee liability Insurance April  2021,-Split-,-776.3,"172,841.70"
,30/04/2022,Ledger Entry,3111,,Admiral  car insurance April 2021,-Split-,-100,"172,741.70"
,30/04/2022,Ledger Entry,3111,,Marc Newton car insurance Revolution,-Split-,-109,"172,632.70"
,4/5/2022,Expense,15,Royal,The Ancient Defender RR1,Payables,"80,000.00","252,632.70"
,15/05/2022,Expense,,The White Horse,The White Horse (Taken via Mews Merchant).,Payables,"1,372.75","254,005.45"
,26/05/2022,Expense,3378,ElS And Co (Pty) Ltd,ELS WSI 1311 - The Klaserie Roorkee,Payables,"3,094.00","257,099.45"
,31/05/2022,Ledger Entry,3115,,Marc Newton car insurance Revolution,-Split-,-109,"256,990.45"
,31/05/2022,Ledger Entry,3115,,West London Shooting School ground rent,-Split-,-143.4,"256,847.05"
,31/05/2022,Ledger Entry,3115,,Admiral  car insurance May 2021,-Split-,-100,"256,747.05"
,31/05/2022,Ledger Entry,3115,,Harper office Packing Material  May 2021,-Split-,-225.62,"256,521.43"
,31/05/2022,Ledger Entry,3115,,Employee liability Insurance May  2021,-Split-,-776.3,"255,745.13"
,31/05/2022,Ledger Entry,3115,,Marine Cargo insurance released from preTransaction,-Split-,-32.18,"255,712.95"
,31/05/2022,Ledger Entry,3115,,Game fair cost released to P & L,-Split-,-534.71,"255,178.24"
,1/6/2022,Expense,PD37,Natraj Publishers,Burning Bright/ Harnihal Singh Sidhu,Payables,200,"255,378.24"
,1/6/2022,Expense,PD37,Natraj Publishers,Postage/Freight,Payables,72.5,"255,450.74"
,11/6/2022,Expense,,Hibo Industies (China) Co.Ltd,"1.Gun Socks
2.Embroidery Ancient logon on
it($730)",Payables,516.47,"255,967.21"
,11/6/2022,Expense,,Hibo Industies (China) Co.Ltd,"1.A4 leather folder, with two
pieces
genuine leather sewing
together(sewing bottom and
left side)
2.Emboss Logo($4180)",Payables,"2,957.35","258,924.56"
,15/06/2022,Ledger Entry,3144,,Stock received from Els & Co,-Split-,"-3,094.00","255,830.56"
,22/06/2022,Expense,2.11E+13,West London Shooting School,Ground rent 01/05/2022 to 30/04/2022,Payables,"2,278.00","258,108.56"
,23/06/2022,Expense,668797,Wbc,Ancient & Co Jute Shopper,Payables,"4,520.00","262,628.56"
,30/06/2022,Ledger Entry,3173,,Employee liability Insurance June 2021,-Split-,-776.3,"261,852.26"
,30/06/2022,Ledger Entry,3173,,Admiral  car insurance June 2021,-Split-,-100,"261,752.26"
,30/06/2022,Ledger Entry,3173,,West London Shooting School ground rent,-Split-,-143.4,"261,608.86"
,30/06/2022,Ledger Entry,3173,,Marc Newton car insurance Revolution,-Split-,-109,"261,499.86"
,30/06/2022,Ledger Entry,3173,,Harper office Packing Material  June 2021,-Split-,-225.62,"261,274.24"
,30/06/2022,Ledger Entry,3173,,Game fair cost released to P & L,-Split-,-534.71,"260,739.53"
,30/06/2022,Ledger Entry,3173,,Marine Cargo insurance released from preTransaction,-Split-,-32.18,"260,707.35"
,1/7/2022,Ledger Entry,3187,,Safary Style bespoke marquee,-Split-,"-12,299.50","248,407.85"
,5/7/2022,Expense,1172,Cooper Roberts,Serviced Fri & Sat PM,Payables,400,"248,807.85"
,5/7/2022,Expense,1172,Cooper Roberts,Shower & Toilet Hire,Payables,"3,000.00","251,807.85"
,5/7/2022,Expense,1172,Cooper Roberts,Bags of Logs,Payables,50,"251,857.85"
,5/7/2022,Expense,1172,Cooper Roberts,"7.5m Portable Flag Pole
Rotating Arm & Gold Finial
1500 x 1000 Flag",Payables,400,"252,257.85"
,5/7/2022,Expense,1172,Cooper Roberts,"Stove, Hearth & Black Flue",Payables,"1,200.00","253,457.85"
,5/7/2022,Expense,1172,Cooper Roberts,Water Reed Bundles x 50,Payables,750,"254,207.85"
,5/7/2022,Expense,1172,Cooper Roberts,Internal Floor 9mx12m,Payables,"1,500.00","255,707.85"
,5/7/2022,Expense,1172,Cooper Roberts,Coir Matting 9m x 12m,Payables,"1,320.00","257,027.85"
,5/7/2022,Expense,2.11E+13,Northwood Group UK Vendor,SauerTitanium Moderator - M15x1 Over Barrel New - Serial FFM-22-9789 (to Carl King),Payables,229,"257,256.85"
,31/07/2022,Ledger Entry,3215,,Marine Cargo insurance released from preTransaction,-Split-,-32.18,"257,224.67"
,31/07/2022,Ledger Entry,3215,,Marc Newton car insurance Revolution,-Split-,-109,"257,115.67"
,31/07/2022,Ledger Entry,3215,,West London Shooting School ground rent,-Split-,-227.8,"256,887.87"
,31/07/2022,Ledger Entry,3215,,Harper office Packing Material  July 2021,-Split-,-225.62,"256,662.25"
,31/07/2022,Ledger Entry,3215,,Employee liability Insurance July 2021,-Split-,-776.3,"255,885.95"
Total for PreTransactions,,,,,,,"£30,170.78  ",
CampusX project,,,,,,,,
,Beginning Balance,,,,,,,"2,650.01"
Total for CampusX project,,,,,,,,
Stock / Inventory Asset,,,,,,,,
,Beginning Balance,,,,,,,"749,824.62"
,1/12/2022,Vendor Credit,,Wbc,CN for duplicate Receipt,Payables,-30.24,"789,058.32"
,1/12/2022,Vendor Credit,698965,Jay Spark Co Ltd,Debit Memo of Receipt no 698055,Payables,-50.87,"789,007.45"
,1/12/2022,Expense,8,Peter Boxall,Trigger guards x 8,Payables,280,"789,287.45"
,1/12/2022,Expense,998,T F Wood & Son,Round Brass Oil Bottle X 10,Payables,530,"789,817.45"
,1/12/2022,Expense,716758,Jay Spark Co Ltd,"Brush, gauge, Jag",Payables,280.28,"790,097.73"
,2/12/2022,Expense,RE-202112/14134,Karl Beier,"Cups, captive flask, triple glass set - 1,090.50 Eur",Payables,948.26,"791,045.99"
,2/12/2022,Expense,938972,Lothar Walther,setup costs for small quantity - special production of barrel blanks with outer - Ø38mm - 290 EUR,Payables,245.76,"791,291.75"
,2/12/2022,Expense,938972,Lothar Walther,partial tool costs - 380 EUR,Payables,322.03,"791,613.78"
,2/12/2022,Expense,938972,Lothar Walther,"partial finished barrel as per dwg. IG_SYS96-63600-1500-01"" cal. .303British / special rifle steel (LW19) - 1,182 EUR",Payables,"1,001.70","792,615.48"
,6/12/2022,Expense,717280,Jay Spark Co Ltd,J27 Bisley Brass Jag,Payables,56.8,"792,672.28"
,15/12/2022,Expense,718158,Jay Spark Co Ltd,J35 Bisley Brass Jag,Payables,14.2,"792,686.48"
,15/12/2022,Ledger Entry,3370,,Ammunition used in the testing of rifles,-Split-,"-1,837.76","790,848.72"
,16/12/2022,Expense,35,Steve Kelly,Spare safe for Stock,Payables,75,"790,923.72"
,17/12/2022,Ledger Entry,3373,,Stock items Fund Transferred to COS,-Split-,-155.91,"790,767.81"
,17/12/2022,Expense,PO2021/179,SASU BYG France,"Ancient sunglases Cape Buffalo  - 3,200 EUR",Payables,"2,711.86","793,479.67"
,17/12/2022,Ledger Entry,3372,,Stock Fund Transferred to WIP,-Split-,"-2,255.86","791,223.81"
,21/12/2022,Ledger Entry,3391,,"Plates 1,2,3,4,5,6 - Silver inlay second, Swiss edition - Vasil",-Split-,"-1,950.00","789,273.81"
,21/12/2022,Ledger Entry,3393,,Bolt assembly without proof-fire and serial number for completion and further processing in the UK,-Split-,"-1,806.00","787,467.81"
,21/12/2022,Ledger Entry,3392,,"Bolt assembly without proof-fire 
and serial number for completion 
and further processing in the UK",-Split-,"-4,386.00","783,081.81"
,23/12/2022,Expense,2056,TimberLake Workshop,Garhwal,Payables,"1,710.00","784,791.81"
,23/12/2022,Expense,2056,TimberLake Workshop,London Best,Payables,"2,025.00","786,816.81"
,31/12/2022,Ledger Entry,3417,,being accessories cost Fund Transfer to P&L,-Split-,"-7,952.28","778,864.53"
,31/12/2022,Ledger Entry,3404,,Item incorrectly posted as stock - this is a cost of sale item,-Split-,-30.24,"778,834.29"
,31/12/2022,Ledger Entry,3409,,Stock items Fund Transferred to WIP,-Split-,-610.13,"778,224.16"
,31/12/2022,Ledger Entry,3405,,Incorrectly posted as stock - this is a cost of sale item,-Split-,-153.33,"778,070.83"
,31/12/2022,Vendor Credit,CN 600630,Traditional English Guncases Ltd,Debit Memo Receipt number 600630,Payables,"-1,800.00","776,270.83"
,31/12/2022,Ledger Entry,3410,,Stock Fund Transferred to WIP,-Split-,"-1,524.75","774,746.08"
,31/12/2022,Ledger Entry,3408,,Stock items Fund Transferred to WIP,-Split-,-784.04,"773,962.04"
,31/12/2022,Ledger Entry,3403,,Items incorrectly posted as stock - these are cost of sale items,-Split-,"-3,473.82","770,488.22"
,31/12/2022,Ledger Entry,3424,,year end adjustment after stock count,-Split-,"-41,925.76","728,562.46"
Total for Stock / Inventory Asset,,,,,,,"-£21,262.16  ",
Stock in Trnasit,,,,,,,,
,Beginning Balance,,,,,,,784.31
,4/6/2022,Expense,8400039001,Northwood Group,"Bolt assembly without proof-fire
and serial number for completion
and
further processing in the UK.",Payables,"10,836.00","11,620.31"
,17/06/2022,Expense,8400037864,Northwood Group,"Bolt assembly without proof-fire
and serial number for completion
and
further processing in the UK.",Payables,"23,909.16","35,529.47"
,17/06/2022,Expense,8400037863,Northwood Group,"Bolt assembly without proof-fire
and serial number for completion
and
further processing in the UK.",Payables,"68,206.05","103,735.52"
,23/06/2022,Expense,8400039002,Northwood Group,"Bolt assembly without proof-fire
and serial number for completion
and
further processing in the UK.",Payables,"2,322.00","106,057.52"
,1/7/2022,Vendor Credit,8400039001,Northwood Group,"Bolt assembly without proof-fire
and serial number for completion
and
further processing in the UK. 
For Receipt 8400039001- Stock arrived",Payables,"-10,836.00","95,221.52"
,1/7/2022,Vendor Credit,8400037864,Northwood Group,"Bolt assembly without proof-fire
and serial number for completion
and
further processing in the UK. 
For Receipt 8400037864- Stock arrived",Payables,"-23,909.16","71,312.36"
,1/7/2022,Vendor Credit,8400039002,Northwood Group,"Bolt assembly without proof-fire
and serial number for completion
and
further processing in the UK. For Receipt 8400039002- Stock arrived",Payables,"-2,322.00","68,990.36"
,1/7/2022,Vendor Credit,8400037863,Northwood Group,"Bolt assembly without proof-fire
and serial number for completion
and
further processing in the UK. 
For Receipt 8400037863- Stock arrived",Payables,"-68,206.05",784.31
,31/07/2022,Ledger Entry,3209,,SNT Adventure Ancient & Co branded 20 oz tumbler,-Split-,-784.31,0
Total for Stock in Trnasit,,,,,,,-£784.31  ,
Work in Progress,,,,,,,,
,Beginning Balance,,,,,,,"1,822,014.80"
,1/1/2022,Expense,2522,Arms Restoration Services,3 off pairs 7x57R chopper lump barrels,Payables,"2,350.00","1,824,364.80"
,1/1/2022,Expense,2522,Arms Restoration Services,3 off pairs 7x57R chopper lump barrels,Payables,"2,350.00","1,826,714.80"
,1/1/2022,Expense,2522,Arms Restoration Services,3 off pairs 7x57R chopper lump barrels,Payables,"2,350.00","1,829,064.80"
,3/1/2022,Expense,340,IPS Gunmaking Ltd,"Stock pair SxS add weight to balance and make off butt end, supply and fit roundals, repairs in stocks, slim down both guards",Payables,"4,324.00","1,833,388.80"
,31/01/2022,Ledger Entry,3015,,Being released to P&L,-Split-,"-2,477.65","1,795,034.39"
,31/12/2022,Ledger Entry,3417,,being released to P&L,-Split-,"-36,150.09","2,138,255.64"
,31/12/2022,Ledger Entry,3417,,being released to P&L,-Split-,"-2,676.06","2,135,579.58"
,31/12/2022,Ledger Entry,3417,,being released to P&L,-Split-,"-2,645.51","2,132,934.07"
,31/12/2022,Ledger Entry,3417,,being released to P&L,-Split-,"-6,345.76","2,126,588.31"
,31/12/2022,Ledger Entry,3417,,being released to P&L,-Split-,"-3,254.55","2,123,333.76"
,31/12/2022,Ledger Entry,3417,,being released to P&L,-Split-,"-6,930.62","2,116,403.14"
,31/12/2022,Ledger Entry,3417,,being released to P&L,-Split-,"-5,732.56","2,110,670.58"
,31/12/2022,Ledger Entry,3417,,being released to P&L,-Split-,"-4,464.71","2,106,205.87"
,31/12/2022,Ledger Entry,3417,,being released to P&L,-Split-,"-7,663.31","2,098,542.56"
,31/12/2022,Ledger Entry,3417,,being released to P&L,-Split-,"-3,133.40","2,095,409.16"
,31/12/2022,Ledger Entry,3417,,being released to P&L,-Split-,"-3,133.40","2,092,275.76"
,31/12/2022,Ledger Entry,3417,,being released to P&L,-Split-,"-3,375.38","2,088,900.38"
,31/12/2022,Ledger Entry,3417,,being released to P&L,-Split-,"-2,719.29","2,086,181.09"
,31/12/2022,Ledger Entry,3417,,being released to P&L,-Split-,"-34,616.38","2,051,564.71"
,31/12/2022,Ledger Entry,3417,,being released to P&L,-Split-,"-26,905.08","2,024,659.63"
,31/12/2022,Ledger Entry,3417,,being released to P&L,-Split-,"-3,331.77","2,021,327.86"
Total for Work in Progress,,,,,,,"£199,313.06  ",
Accumulated Depreciation,,,,,,,,
,Beginning Balance,,,,,,,"-78,510.79"
,31/01/2022,Ledger Entry,3018,,Jan 2021 depreciation,-Split-,"-1,300.00","-79,810.79"
,28/02/2022,Ledger Entry,3046,,Feb 2021 depreciation,-Split-,"-1,300.00","-81,110.79"
,31/03/2022,Ledger Entry,3072,,March 2021 depreciation,-Split-,"-1,300.00","-82,410.79"
,30/04/2022,Ledger Entry,3111,,April  2021 depreciation,-Split-,"-1,300.00","-83,710.79"
,31/05/2022,Ledger Entry,3115,,May 2021 depreciation,-Split-,"-1,300.00","-85,010.79"
,30/06/2022,Ledger Entry,3173,,June 2021 depreciation,-Split-,"-1,300.00","-86,310.79"
,31/07/2022,Ledger Entry,3215,,July 2021 depreciation,-Split-,"-1,300.00","-87,610.79"
,31/08/2022,Ledger Entry,3249,,August 2021 depreciation,-Split-,"-1,300.00","-88,910.79"
,30/09/2022,Ledger Entry,3281,,Sept 2021 depreciation,-Split-,"-1,300.00","-90,210.79"
,31/10/2022,Ledger Entry,3328,,Oct 2021 depreciation,-Split-,"-1,300.00","-91,510.79"
,30/11/2022,Ledger Entry,3364,,Nov  2021 depreciation,-Split-,"-1,300.00","-92,810.79"
,31/12/2022,Ledger Entry,3421,,Dec  2021 depreciation,-Split-,"-1,300.00","-94,110.79"
,31/12/2022,Ledger Entry,3425,,Depreciation for 2021 adjustment,-Split-,"-7,524.74","-101,635.53"
Total for Accumulated Depreciation,,,,,,,"-£23,124.74  ",
Furniture and Fixtures,,,,,,,,
,Beginning Balance,,,,,,,"71,998.47"
,19/03/2022,Expense,51,IDR Associates,Replace industrial shutter,Payables,"4,585.00","76,583.47"
,19/03/2022,Expense,51,IDR Associates,"Travel, admin, materials",Payables,53.76,"76,637.23"
,1/7/2022,Ledger Entry,3187,,Safary Style bespoke marquee,-Split-,"12,299.50","88,936.73"
,5/7/2022,Expense,1172,Cooper Roberts,Artificial Palm Trees (various x 13),Payables,"1,500.00","90,436.73"
,5/7/2022,Expense,1172,Cooper Roberts,Stone Fire Pit (Dry Stone Waller),Payables,600,"91,036.73"
,5/7/2022,Expense,1172,Cooper Roberts,Polished Spotlight for Logo,Payables,100,"91,136.73"
,5/7/2022,Expense,1172,Cooper Roberts,"Internal Giant Globe Bulb & Brass Lampholder
Plus Wiring",Payables,600,"91,736.73"
,5/7/2022,Expense,1172,Cooper Roberts,Display Cabinet & Glass,Payables,"3,000.00","94,736.73"
,19/07/2022,Expense,20792,TMC Ltd,Design & supply of 9m x 12m bespoke safari Style tent,Payables,"14,504.50","109,241.23"
,18/10/2022,Expense,1,Lancashire Timber,Coffee Table,Payables,300,"109,541.23"
Total for Furniture and Fixtures,,,,,,,"£37,542.76  ",
Guns & Rifles - Museum,,,,,,,,
,Beginning Balance,,,,,,,"313,207.33"
Total for Guns & Rifles - Museum,,,,,,,,
Machinery,,,,,,,,
,Beginning Balance,,,,,,,"50,903.92"
,1/2/2022,Expense,59290,George Mudge & Co,Thiel universal milling machine complete with tooling,Payables,"3,750.00","54,653.92"
,27/04/2022,Expense,445,ARC Ballistics Limited,500 JEFFERY FINISHING CHAMBER REAME,Payables,275,"54,928.92"
,27/04/2022,Expense,445,ARC Ballistics Limited,300 H&H THROAT/FREE BORE GAUGE,Payables,70,"54,998.92"
,27/04/2022,Expense,445,ARC Ballistics Limited,300 H&H BODY GAUGE,Payables,58.5,"55,057.42"
,27/04/2022,Expense,445,ARC Ballistics Limited,300 H&H NO GO GAUGE,Payables,58.5,"55,115.92"
,27/04/2022,Expense,445,ARC Ballistics Limited,300 H&H GO GAUGE,Payables,58.5,"55,174.42"
,27/04/2022,Expense,445,ARC Ballistics Limited,300 H&H THROAT/FREEBORE REAMER,Payables,221,"55,395.42"
,27/04/2022,Expense,445,ARC Ballistics Limited,300 H&H FINISHING CHAMBER REAMER,Payables,221,"55,616.42"
,27/04/2022,Expense,445,ARC Ballistics Limited,300 H&H ROUGHING CHAMBER REAME,Payables,221,"55,837.42"
,27/04/2022,Expense,445,ARC Ballistics Limited,500 JEFFERY THROAT/FREEBORE REAMER,Payables,275,"56,112.42"
,27/04/2022,Expense,445,ARC Ballistics Limited,500 JEFFERY ROUGHING CHAMBER REAMER,Payables,275,"56,387.42"
,27/04/2022,Expense,445,ARC Ballistics Limited,404 JEFFERY THROAT/FREEBORE REAMER,Payables,221,"56,608.42"
,24/11/2022,Expense,538,ARC Ballistics Limited,500 JEFFERY CIP FREEBORE GAUGE,Payables,70,"65,057.06"
,24/11/2022,Expense,538,ARC Ballistics Limited,500 JEFFERY CIP GO GAUG,Payables,58.5,"65,115.56"
,31/12/2022,Bank Draft,1571,,Combi drill,Business Card,254.15,"65,369.71"
Total for Machinery,,,,,,,"£14,465.79  ",
Museum Items,,,,,,,,
,Beginning Balance,,,,,,,"20,170.77"
Total for Museum Items,,,,,,,,
Office equipment,,,,,,,,
,Beginning Balance,,,,,,,"22,892.48"
,31/08/2022,Bank Draft,1205,,office chairs,Business Card,116.58,"23,009.06"
,31/08/2022,Bank Draft,1202,,office chairs,Business Card,116.58,"23,125.64"
,31/08/2022,Bank Draft,1204,,office chairs,Business Card,116.58,"23,242.22"
,31/08/2022,Bank Draft,1203,,office chairs,Business Card,116.66,"23,358.88"
,31/10/2022,Bank Draft,1376,,Dymo LabelWriter 450 Twin Turbo Label Maker,Business Card,138.33,"23,497.21"
Total for Office equipment,,,,,,,£604.73  ,
Research and Development,,,,,,,,
,Beginning Balance,,,,,,,"305,559.28"
,31/01/2022,Ledger Entry,3018,,amortising of R & D for January 2021,-Split-,"-2,272.06","303,287.22"
,28/02/2022,Ledger Entry,3046,,amortising of R & D for Feb 2021,-Split-,"-2,272.06","301,015.16"
,29/03/2022,Expense,16925,Aform Tooling Limited,Cocking piece,Payables,880,"301,895.16"
,31/03/2022,Ledger Entry,3072,,amortising of R & D for March 2021,-Split-,"-2,272.06","299,623.10"
,30/04/2022,Ledger Entry,3111,,amortising of R & D for April2021,-Split-,"-2,272.06","297,351.04"
,31/05/2022,Ledger Entry,3115,,amortising of R & D for May 2021,-Split-,"-2,272.06","295,078.98"
,1/10/2022,Expense,713,Parthoens,"Etude et developpement take-down, realisation des pieces ,Sous gardes , Logos,Pontets,modifications queue de culasse, inserts de queu de culasse,modifications du systeme de detente,usinage 3 crosses, montage a bois proto 1 et validation du principe, magasin, canon 0.275 - 9,455 EUR",Payables,"8,220.44","319,283.75"
,31/10/2022,Ledger Entry,3328,,amortising of R & D for Oct 2021,-Split-,"-2,500.00","316,783.75"
,30/11/2022,Ledger Entry,3364,,amortising of R & D for Nov2021,-Split-,"-2,500.00","314,283.75"
,31/12/2022,Ledger Entry,3421,,amortising of R & D for Dec 21,-Split-,"-2,500.00","311,783.75"
Total for Research and Development,,,,,,,"£6,224.47  ",
Vehicles,,,,,,,,
,1/12/2022,Expense,600626,Traditional English Guncases Ltd,Case for Defender s/n RR1,Payables,"1,666.67","1,666.67"
,31/12/2022,Ledger Entry,3401,,Royal Gun Cases RR1,-Split-,"2,735.00","4,401.67"
,31/12/2022,Ledger Entry,3401,,Ice Bucket from BrandCo Branding Ltd Inv 113593 RR1,-Split-,66,"4,467.67"
,31/12/2022,Ledger Entry,3401,,Landrover sweat from TEG 6005258 RR1,-Split-,"5,000.00","9,467.67"
,31/12/2022,Ledger Entry,3401,,Royal Landrover RR1 being  Fund Transferred from preTransaction,-Split-,"80,000.00","89,467.67"
,31/12/2022,Ledger Entry,3401,,Orbit Crystallite High ball from BrandCo Branding RR1,-Split-,265.16,"89,732.83"
,31/12/2022,Ledger Entry,3401,,Ice Bucket from BrandCo Branding Ltd Inv 113593 RR1,-Split-,202,"89,934.83"
Total for Vehicles,,,,,,,"£89,934.83  ",
Web development,,,,,,,,
,Beginning Balance,,,,,,,"22,878.63"
Total for Web development,,,,,,,,
Payables,,,,,,,,
,Beginning Balance,,,,,,,"956,153.60"
,1/1/2022,Vendor Credit,,West London Shooting School,,MARKETING/SELLING:Staff welfare and Training,-168.88,"955,984.72"
,1/1/2022,Expense,16776,GWT Media,,-Split-,203.4,"956,188.12"
,1/1/2022,Expense,6615,Field Sports Publishing Inc,Exchange rate £1 = £1.3658,MARKETING/SELLING:Marketing,"2,782.12","958,970.24"
,1/1/2022,Expense,2700,Julian & Sons,$800 @ 1.328944,Cost of sales,616.34,"959,586.58"
,1/1/2022,Expense,2522,Arms Restoration Services,,-Split-,"8,460.00","968,046.58"
,1/1/2022,Expense,201817,Debbie Thomas,,-Split-,820,"968,866.58"
,1/1/2022,Expense,1179,McLaughin Custom Firearms,16820 @ 1.30,Stock / Inventory Asset,"12,600.00","981,466.58"
,2/1/2022,Expense,10025,SNT Adventure Brands LLC,£1 = $1.366,Shipping & Freight,225.97,"981,692.55"
,2/1/2022,Expense,,Jamie,,-Split-,247.36,"981,939.91"
,3/1/2022,Expense,340,IPS Gunmaking Ltd,,-Split-,"8,648.00","990,587.91"
,4/1/2022,Expense Transaction (Bank Draft),Mary1201,Four Walls Wine,,EastX ****2310,"-1,318.75","989,269.16"
,4/1/2022,Expense Transaction (Bank Draft),Mary1202,TimberLake Workshop,,EastX ****2310,-374.4,"988,894.76"
,4/1/2022,Expense Transaction (Bank Draft),Mary1224,Big Yellow Self Storage,,EastX ****2310,"-1,101.68","987,793.08"
,4/1/2022,Expense Transaction (Bank Draft),Mary1212,A T Miles,,EastX ****2310,"-2,410.00","985,383.08"
,4/1/2022,Expense Transaction (Bank Draft),Mary1199,WORKMAN EDWARD,,EastX ****2310,"-2,022.31","983,360.77"
,4/1/2022,Expense Transaction (Bank Draft),Mary1198,Albion Saddlemakers Co Ltd,,EastX ****2310,"-1,086.90","982,273.87"
,4/1/2022,Expense Transaction (Bank Draft),Mary1200,A G Sinnett,,EastX ****2310,-113.44,"982,160.43"
,5/1/2022,Expense,156673,Hull Cartridge Company Limited,,Cost of sales,30.23,"982,190.66"
,5/1/2022,Expense,14610,Northwood Group UK Vendor,To be Receiptd to Sheikh Salamn,Cost of sales,"5,576.40","987,767.06"
,5/1/2022,Expense,14609,Northwood Group UK Vendor,To be Receiptd to Sheikh Khalid,-Split-,"11,160.00","998,927.06"
,5/1/2022,Expense,082019-16-Closing,BROS. OF THE VALLEY CORP,,MARKETING/SELLING:Postage and Delivery,"1,364.25","1,000,291.31"
,5/1/2022,Expense Transaction (Bank Draft),Mary1206,Hull Cartridge Company Limited,,EastX ****2310,-30.23,"1,000,261.08"
,5/1/2022,Expense Transaction (Bank Draft),Mary1209,Julian & Sons,,EastX ****2310,-616.34,"999,644.74"
,5/1/2022,Expense Transaction (Bank Draft),Mary1207,Jerome  Lannoue,,EastX ****2310,-344.85,"999,299.89"
,5/1/2022,Expense Transaction (Bank Draft),Mary1205,Harper Office,,EastX ****2310,"-3,249.00","996,050.89"
,5/1/2022,Expense Transaction (Bank Draft),Mary1204,Giles Marriott Ltd,,EastX ****2310,"-24,000.00","972,050.89"
,5/1/2022,Expense,202002,Romain Lepinois,,-Split-,"6,120.00","978,170.89"
,6/1/2022,Vendor Credit,,SNT Adventure Brands LLC,,ADMINISTRATION:Exchange Rate cost,-2.92,"978,167.97"
,6/1/2022,Expense Transaction (Bank Draft),Mary1228,SNT Adventure Brands LLC,,EastX ****2310,-819.19,"977,348.78"
,6/1/2022,Expense,Ancient10,Dirty laundry,,ADMINISTRATION:Cleaning Supplies,19.2,"977,367.98"
,6/1/2022,Expense,,BROS. OF THE VALLEY CORP,,ADMINISTRATION:Bank & card charges,15,"977,382.98"
,6/1/2022,Expense,134,Fox & Co Bespokw Ltd,,-Split-,192,"977,574.98"
,7/1/2022,Expense Transaction (Bank Draft),Mary1230,Jamie,,EastX ****2310,-255.1,"977,319.88"
,7/1/2022,Expense Transaction (Bank Draft),Mary1208,Jerome  Lannoue,,EastX ****2310,"-1,636.10","975,683.78"
,7/1/2022,Expense,,Jerome  Lannoue,,ADMINISTRATION:Exchange Rate cost,8.05,"975,691.83"
,7/1/2022,Expense Transaction (Bank Draft),Mary1211,Worldpay,,EastX ****2310,-103.82,"975,588.01"
,7/1/2022,Expense,2336328,Cooksongold,,Stock / Inventory Asset,135.73,"975,723.74"
,7/1/2022,Expense Transaction (Bank Draft),Mary1229,BROS. OF THE VALLEY CORP,,EastX ****2310,"-1,379.25","974,344.49"
,8/1/2022,Expense,,Ian Clarke,,-Split-,301.5,"974,645.99"
,8/1/2022,Expense Transaction (Bank Draft),Mary1210,Worldpay,,EastX ****2310,"-1,964.55","972,681.44"
,11/1/2022,Expense Transaction (Bank Draft),Mary1215,SRS Freight Ltd,,EastX ****2310,"-9,399.56","963,281.88"
,11/1/2022,Expense Transaction (Bank Draft),Mary1213,John Whitfield,,EastX ****2310,-960,"962,321.88"
,11/1/2022,Expense,,Jamie,,-Split-,255.1,"962,576.98"
,11/1/2022,Expense,176725,Industrial Boilerhouse Supplies Ltd,,-Split-,762,"963,338.98"
,11/1/2022,Expense,244,Brock & Norris,,-Split-,176.62,"963,515.60"
,11/1/2022,Expense Transaction (Bank Draft),9256,Northwood GMBH,,EastX Bank,"-70,000.00","893,515.60"
,12/1/2022,Expense,21200914,Swarovski Optik,,Cost of sales,"1,737.75","895,253.35"
,13/01/2022,Expense Transaction (Bank Draft),Mary1217,Bronze Age Art Foundry Limited,,EastX ****2310,-621,"894,632.35"
,13/01/2022,Expense Transaction (Bank Draft),Mary1218,Ben Becker,,EastX ****2310,-398.75,"894,233.60"
,13/01/2022,Expense Transaction (Bank Draft),Mary1216,Romain Lepinois,,EastX ****2310,"-6,135.00","888,098.60"
,13/01/2022,Expense,16808,GWT Media,,ADMINISTRATION:Computer and Internet Expenses,45,"888,143.60"
,13/01/2022,Expense,102424,SRS Freight Ltd,,MARKETING/SELLING:Postage and Delivery,48,"888,191.60"
,13/01/2022,Expense,Ancient11,Dirty laundry,,ADMINISTRATION:Cleaning Supplies,19.2,"888,210.80"
,13/01/2022,Expense,,Romain Lepinois,,ADMINISTRATION:Exchange Rate cost,15,"888,225.80"
,13/01/2022,Expense,R17-04-45,IDR Associates,,MARKETING/SELLING:Repair and maintenance,525.96,"888,751.76"
,13/01/2022,Expense,24292,British Sporting Arms Ltd,Exchange rate £1 = $1.3588,-Split-,255.12,"889,006.88"
,14/01/2022,Expense Transaction (Bank Draft),Mary1220,Mayfair  Engineering,,EastX ****2310,"-3,402.00","885,604.88"
,15/01/2022,Expense,32404,Carrs Welding Technologies Ltd,,-Split-,350.1,"885,954.98"
,15/01/2022,Expense,3565,Tweed Media,,-Split-,"5,165.39","891,120.37"
,15/01/2022,Expense,861,SonySports Press Limited,,MARKETING/SELLING:Marketing,"1,794.00","892,914.37"
,18/01/2022,Expense,9062288540,Parcelforce,,MARKETING/SELLING:Postage and Delivery,7.69,"892,922.06"
,18/01/2022,Expense,,AXA Insurance,Exchange rate £1 = 1.1168 Eur,ADMINISTRATION:Insurance Expense,928.45,"893,850.51"
,18/01/2022,Expense,NI141929,Big Yellow Self Storage,,-Split-,"1,101.68","894,952.19"
,18/01/2022,Expense,9062284174,Parcelforce,,MARKETING/SELLING:Postage and Delivery,219.9,"895,172.09"
,19/01/2022,Expense,102439,SRS Freight Ltd,,MARKETING/SELLING:Postage and Delivery,758.12,"895,930.21"
,19/01/2022,Expense,11941,Bronze Age Art Foundry Limited,,-Split-,942,"896,872.21"
,19/01/2022,Expense,21/52,Stephen Wood,,-Split-,147,"897,019.21"
,19/01/2022,Expense,H1964D592E,eon,,ADMINISTRATION:Utilities,56.09,"897,075.30"
,19/01/2022,Expense,H1964D24CE,eon,,ADMINISTRATION:Utilities,81.38,"897,156.68"
,19/01/2022,Expense,H1964D24E3,eon,,ADMINISTRATION:Utilities,332.12,"897,488.80"
,19/01/2022,Expense,414853,P Higgins & Sons Ltd,,Work in Progress,"2,400.00","899,888.80"
,20/01/2022,Expense Transaction (Bank Draft),9257,Northwood GMBH,,EastX Bank,"-46,531.27","853,357.53"
,20/01/2022,Expense Transaction (Bank Draft),Mary1240,Excelmate,,EastX ****2310,-30,"853,327.53"
,20/01/2022,Expense,,GWT Media,,-Split-,630,"853,957.53"
,20/01/2022,Expense,102446,SRS Freight Ltd,,MARKETING/SELLING:Postage and Delivery,846.5,"854,804.03"
,20/01/2022,Expense,774,Musselbrook Machine Maintenance Ltd,,MARKETING/SELLING:Repair and maintenance,336,"855,140.03"
,21/01/2022,Expense Transaction (Bank Draft),Mary1236,Musselbrook Machine Maintenance Ltd,,EastX ****2310,-336,"854,804.03"
,21/01/2022,Expense Transaction (Bank Draft),Mary1267,Ian Clarke,,EastX ****2310,-301.5,"854,502.53"
,21/01/2022,Expense,11132,Excelmate,,MARKETING/SELLING:Consultants,30,"854,532.53"
,21/01/2022,Expense,8400003650,Northwood Group,,MARKETING/SELLING:Postage and Delivery,559.83,"855,092.36"
,21/01/2022,Expense,1633,TimberLake Workshop,,-Split-,"4,086.00","859,178.36"
,22/01/2022,Expense Transaction (Bank Draft),Mary1257,Teague Precision Chokes Ltd,,EastX ****2310,"-1,099.13","858,079.23"
,22/01/2022,Expense,,Kahles,,ADMINISTRATION:Exchange Rate cost,4.64,"858,083.87"
,22/01/2022,Expense Transaction (Bank Draft),Mary1250,IPS Gunmaking Ltd,,EastX ****2310,"-8,648.00","849,435.87"
,22/01/2022,Expense Transaction (Bank Draft),Mary1262,Stephen Wood,,EastX ****2310,-147,"849,288.87"
,22/01/2022,Expense Transaction (Bank Draft),Mary1261,Beck Office,,EastX ****2310,-72,"849,216.87"
,22/01/2022,Expense Transaction (Bank Draft),Mary1260,Traditional English Guncases Ltd,,EastX ****2310,"-18,708.00","830,508.87"
,22/01/2022,Expense Transaction (Bank Draft),Mary1259,The Gun Trade Association,,EastX ****2310,-429.6,"830,079.27"
,22/01/2022,Expense Transaction (Bank Draft),Mary1258,The Company of Gunmakers,,EastX ****2310,"-2,304.03","827,775.24"
,22/01/2022,Expense Transaction (Bank Draft),Mary1256,Ray St Ledger & Sons,,EastX ****2310,"-3,429.60","824,345.64"
,22/01/2022,Expense Transaction (Bank Draft),Mary1255,Manchester Automatic Machining,,EastX ****2310,-310.8,"824,034.84"
,22/01/2022,Expense Transaction (Bank Draft),Mary1253,Kahles,,EastX ****2310,-885.89,"823,148.95"
,22/01/2022,Expense Transaction (Bank Draft),Mary1252,Johnsons & Co Ltd,,EastX ****2310,-331.2,"822,817.75"
,22/01/2022,Expense Transaction (Bank Draft),Mary1251,Johnsons & Co Ltd,,EastX ****2310,"-6,100.80","816,716.95"
,22/01/2022,Expense Transaction (Bank Draft),Mary1249,IDR Associates,,EastX ****2310,-525.96,"816,190.99"
,22/01/2022,Expense Transaction (Bank Draft),Mary1247,Fox & Co Bespokw Ltd,,EastX ****2310,"-6,100.80","810,090.19"
,22/01/2022,Expense Transaction (Bank Draft),Mary1245,Brock & Norris,,EastX ****2310,-176.82,"809,913.37"
,22/01/2022,Expense Transaction (Bank Draft),Mary1244,British Sporting Arms Ltd,,EastX ****2310,-255.12,"809,658.25"
,22/01/2022,Expense Transaction (Bank Draft),Mary1242,Northwood Group UK Vendor,,EastX ****2310,-510.6,"809,147.65"
,22/01/2022,Expense Transaction (Bank Draft),Mary1241,ARC,,EastX ****2310,-120,"809,027.65"
,22/01/2022,Expense Transaction (Bank Draft),Mary1248,GWT Media,,EastX ****2310,-248.4,"808,779.25"
,22/01/2022,Expense Transaction (Bank Draft),Mary1264,Lothar Walther,,EastX ****2310,"-12,051.38","796,727.87"
,22/01/2022,Expense,,Laser Welding Services,,-Split-,427.92,"797,155.79"
,22/01/2022,Expense Transaction (Bank Draft),Mary1246,Dirty laundry,,EastX ****2310,-38.4,"797,117.39"
,25/01/2022,Expense,600474,Traditional English Guncases Ltd,,Cost of sales,"4,500.00","801,617.39"
,25/01/2022,Expense,,Jerome  Lannoue,,MARKETING/SELLING:Travel Expense,336,"801,953.39"
,25/01/2022,Expense,,Beck Office,,Bookkeeping & Payroll,72,"802,025.39"
,26/01/2022,Expense,,Traditional English Guncases Ltd,,Stock / Inventory Asset,"3,840.00","805,865.39"
,26/01/2022,Expense,3133,ElS And Co (Pty) Ltd,,MARKETING/SELLING:Import Duty,808.25,"806,673.64"
,26/01/2022,Expense,,Steve Helsley,,Cost of sales,656,"807,329.64"
,26/01/2022,Expense,,Traditional English Guncases Ltd,,Cost of sales,432,"807,761.64"
,26/01/2022,Expense,,Traditional English Guncases Ltd,,Work in Progress,"4,380.00","812,141.64"
,26/01/2022,Expense,3132,ElS And Co (Pty) Ltd,,-Split-,318,"812,459.64"
,27/01/2022,Vendor Credit,,Kahles,,Cost of sales,-26.44,"812,433.20"
,27/01/2022,Expense Transaction (Bank Draft),Mary1272,P Higgins & Sons Ltd,,EastX ****2310,-245.34,"812,187.86"
,27/01/2022,Expense,,Henry Krank,,-Split-,52.27,"812,240.13"
,27/01/2022,Expense Transaction (Bank Draft),Mary1273,P Higgins & Sons Ltd,,EastX ****2310,"-2,154.66","810,085.47"
,27/01/2022,Expense Transaction (Bank Draft),Mary1266,Shooting Star,,EastX ****2310,"-5,475.00","804,610.47"
,27/01/2022,Expense Transaction (Bank Draft),Mary1270,Kerast,,EastX ****2310,"-3,330.00","801,280.47"
,28/01/2022,Expense,,Northwood USA,£1 = $1.30,MARKETING/SELLING:Consultants,"4,823.70","806,104.17"
,29/01/2022,Expense Transaction (Bank Draft),9180,Tweed Media,,Apple Account,-0.08,"806,104.09"
,29/01/2022,Expense,70474,Harper Office,,ADMINISTRATION:Office Supplies,67.2,"806,171.29"
,29/01/2022,Expense Transaction (Bank Draft),9264,ElS And Co (Pty) Ltd,,EastX Bank,"-1,126.25","805,045.04"
,29/01/2022,Expense Transaction (Bank Draft),Mary1275,Tweed Media,,EastX ****2310,"-5,165.31","799,879.73"
,30/01/2022,Expense,C 2021/009,Northwood Group,,Shared cost,"1,015.00","800,894.73"
,31/01/2022,Expense Transaction (Bank Draft),762,Heritage pvt Ltd,,Business Card,"-1,509.60","799,385.13"
,31/01/2022,Expense,,Northwood Group,,Shared cost,"2,636.50","802,021.63"
,31/01/2022,Expense,,L & O Immobilien GMBH & Co KG,,ADMINISTRATION:Rent & Rates Expense,"10,666.11","812,687.74"
,31/01/2022,Expense,,Worldpay,,ADMINISTRATION:Bank & card charges,59,"812,746.74"
,1/2/2022,Expense Transaction (Bank Draft),Mary1293,Big Yellow Self Storage,,EastX ****2310,"-1,101.68","811,645.06"
,1/2/2022,Expense,102413,SRS Freight Ltd,,MARKETING/SELLING:Postage and Delivery,"1,238.53","812,883.59"
,1/2/2022,Expense Transaction (Bank Draft),Mary1284,Traditional English Guncases Ltd,,EastX ****2310,"-13,152.00","799,731.59"
,1/2/2022,Expense Transaction (Bank Draft),Mary1295,eon,,EastX ****2310,-56.09,"799,675.50"
,1/2/2022,Expense Transaction (Bank Draft),Mary1282,Arms Restoration Services,,EastX ****2310,"-8,460.00","791,215.50"
,1/2/2022,Expense Transaction (Bank Draft),Mary1283,Debbie Thomas,,EastX ****2310,-820,"790,395.50"
,1/2/2022,Expense Transaction (Bank Draft),Mary1281,Jerome  Lannoue,,EastX ****2310,-336,"790,059.50"
,1/2/2022,Expense,59290,George Mudge & Co,,Machinery,"4,500.00","794,559.50"
,1/2/2022,Expense,451,London Barrel Maker,,-Split-,"5,400.00","799,959.50"
,1/2/2022,Expense,1120,Cooper Roberts,,Storage,270,"800,229.50"
,1/2/2022,Expense,16885,GWT Media,,ADMINISTRATION:Computer and Internet Expenses,203.4,"800,432.90"
,1/2/2022,Expense,74980,Kerast,,Work in Progress,210,"800,642.90"
,1/2/2022,Expense,2540,First Sight Design Ltd,,ADMINISTRATION:Office Supplies,720,"801,362.90"
,1/2/2022,Expense,240676,Lothar Walther,£1 = 1.1284 Eur,-Split-,"1,687.61","803,050.51"
,1/2/2022,Expense,240844,Lothar Walther,,-Split-,"9,965.73","813,016.24"
,1/2/2022,Expense,006/2020,Traditional Fine Engraving,£1 = 1.1076 Eur,Work in Progress,"9,028.50","822,044.74"
,1/2/2022,Expense,,WORKMAN EDWARD,,-Split-,"1,517.01","823,561.75"
,1/2/2022,Vendor Credit,,Triebel GMBH,,ADMINISTRATION:Exchange Rate cost,-36.53,"823,525.22"
,1/2/2022,Expense,41.2,T & D O'Neill,,-Split-,210,"823,735.22"
,1/2/2022,Expense,102447,SRS Freight Ltd,,MARKETING/SELLING:Postage and Delivery,"3,716.90","827,452.12"
,1/2/2022,Expense,1.2,T & D O'Neill,,-Split-,210,"827,662.12"
,1/2/2022,Expense,3.2,T & D O'Neill,,-Split-,280,"827,942.12"
,1/2/2022,Expense,2.2,T & D O'Neill,,-Split-,340,"828,282.12"
,1/2/2022,Expense,102467,SRS Freight Ltd,,MARKETING/SELLING:Postage and Delivery,140,"828,422.12"
,1/2/2022,Expense,74981,Kerast,,Work in Progress,150,"828,572.12"
,1/2/2022,Expense,74982,Kerast,,Stock / Inventory Asset,210,"828,782.12"
,1/2/2022,Expense,,Mark Remmant,,-Split-,112,"828,894.12"
,1/2/2022,Expense,2021-0002,Revolution Wines,,MARKETING/SELLING:Postage and Delivery,24,"828,918.12"
,1/2/2022,Expense,I010066008,Sage UK Limited,,ADMINISTRATION:Office - Computer expenses,"1,189.03","830,107.15"
,1/2/2022,Expense,74978,Kerast,,Cost of sales,116.4,"830,223.55"
,1/2/2022,Expense,74979,Kerast,,Cost of sales,690,"830,913.55"
,1/2/2022,Expense,,A G Sinnett,,-Split-,165.89,"831,079.44"
,1/2/2022,Expense,40.2,T & D O'Neill,,-Split-,300,"831,379.44"
,1/2/2022,Expense,PI46,Natraj Publishers,,-Split-,395,"831,774.44"
,1/2/2022,Expense Transaction (Bank Draft),Mary1280,Triebel GMBH,,EastX ****2310,"-2,350.22","829,424.22"
,2/2/2022,Expense,17307,Kynamco Limited,,-Split-,"1,637.40","831,061.62"
,2/2/2022,Expense,2724,Julian & Sons,$1200 = $1.369,Storage,886.42,"831,948.04"
,3/2/2022,Expense Transaction (Bank Draft),9266,eon,,EastX Bank,-332.12,"831,615.92"
,3/2/2022,Expense,2021-10675,Recknagel,,-Split-,839.37,"832,455.29"
,3/2/2022,Expense Transaction (Bank Draft),9267,eon,,EastX Bank,-81.38,"832,373.91"
,4/2/2022,Expense Transaction (Bank Draft),Mary1278,Convergence,,EastX ****2310,"-1,597.96","830,775.95"
,4/2/2022,Expense Transaction (Bank Draft),9268,L & O Immobilien GMBH & Co KG,,EastX Bank,"-10,666.11","820,109.84"
,4/2/2022,Expense Transaction (Bank Draft),Mary1277,Jamie,,EastX ****2310,-247.36,"819,862.48"
,4/2/2022,Expense,2021-A-329,Negrini,,Cost of sales,685.67,"820,548.15"
,4/2/2022,Vendor Credit,,Convergence,,ADMINISTRATION:Exchange Rate cost,-7.54,"820,540.61"
,4/2/2022,Expense,2100214,EXSTO Italia SRL,£1=1.1327 Eur,-Split-,382.85,"820,923.46"
,4/2/2022,Expense,64885,ARC,,ADMINISTRATION:Office Supplies,42.91,"820,966.37"
,4/2/2022,Expense Transaction (Bank Draft),Mary1297,Raytrade UK Ltd,,EastX ****2310,-248.4,"820,717.97"
,5/2/2022,Expense Transaction (Bank Draft),Mary1299,Negrini,,EastX ****2310,-685.67,"820,032.30"
,5/2/2022,Expense Transaction (Bank Draft),Mary1298,A G Sinnett,,EastX ****2310,-165.89,"819,866.41"
,5/2/2022,Expense,,David E Josey,,Work in Progress,"2,000.00","821,866.41"
,5/2/2022,Expense,76448,Mike Ball,,Materials & Tools,732.7,"822,599.11"
,5/2/2022,Expense,21398804,Rentokil,,MARKETING/SELLING:Repair and maintenance,352.78,"822,951.89"
,5/2/2022,Expense,5919,CA Bookkeeping Services Ltd,,-Split-,"2,383.20","825,335.09"
,8/2/2022,Expense Transaction (Bank Draft),Mary1352,CA Bookkeeping Services Ltd,,EastX ****2310,"-2,383.20","822,951.89"
,8/2/2022,Expense,4.17E+15,Parcelforce,,Stock / Inventory Asset,136.51,"823,088.40"
,8/2/2022,Expense,600489,Traditional English Guncases Ltd,,Work in Progress,"4,380.00","827,468.40"
,8/2/2022,Expense,600488,Traditional English Guncases Ltd,,-Split-,"4,080.00","831,548.40"
,8/2/2022,Expense,61327,Manchester Automatic Machining,,-Split-,701.4,"832,249.80"
,8/2/2022,Expense,28,Steve Kelly,,-Split-,456.48,"832,706.28"
,9/2/2022,Expense Transaction (Bank Draft),Mary1301,First Sight Design Ltd,,EastX ****2310,-720,"831,986.28"
,9/2/2022,Expense Transaction (Bank Draft),Mary1288,dr. E. Stief - Jagdwaffen,,EastX ****2310,-849.45,"831,136.83"
,9/2/2022,Expense Transaction (Bank Draft),Mary1287,Guns On Pegs,,EastX ****2310,-714,"830,422.83"
,9/2/2022,Expense,Ancient12,Dirty laundry,,ADMINISTRATION:Cleaning Supplies,19.2,"830,442.03"
,9/2/2022,Vendor Credit,,Guns On Pegs,,MARKETING/SELLING:Marketing,-727,"829,715.03"
,9/2/2022,Expense,2.10E+13,Raytrade UK Ltd,,-Split-,248.4,"829,963.43"
,9/2/2022,Expense,67233,Sharmic Engineering Limited,,-Split-,418.5,"830,381.93"
,9/2/2022,Expense,,William Wild,,Work in Progress,750,"831,131.93"
,9/2/2022,Vendor Credit,,dr. E. Stief - Jagdwaffen,,ADMINISTRATION:Exchange Rate cost,-19.5,"831,112.43"
,9/2/2022,Expense,220,Johnsons & Co Ltd,,Cost of sales,"2,100.00","833,212.43"
,10/2/2022,Expense Transaction (Bank Draft),Mary1325,WORKMAN EDWARD,,EastX ****2310,"-1,517.01","831,695.42"
,10/2/2022,Expense Transaction (Bank Draft),Mary1326,William Wild,,EastX ****2310,-750,"830,945.42"
,10/2/2022,Expense,,Waffen Ulrich AG,,ADMINISTRATION:Bank & card charges,15,"830,960.42"
,10/2/2022,Expense Transaction (Bank Draft),Mary1290,Waffen Ulrich AG,,EastX ****2310,"-1,015.00","829,945.42"
,10/2/2022,Expense,23,BF&D LIMITED,,Cost of sales,"1,200.00","831,145.42"
,10/2/2022,Expense Transaction (Bank Draft),Mary1324,Worldpay,,EastX ****2310,-59,"831,086.42"
,11/2/2022,Expense,,Alan Rhone lTD,,-Split-,409.61,"831,496.03"
,11/2/2022,Expense,F003827,Eurl Remi Richard,,Stock / Inventory Asset,400,"831,896.03"
,12/2/2022,Expense Transaction (Bank Draft),Mary1304,McLaughin Custom Firearms,,EastX ****2310,"-5,955.74","825,940.29"
,12/2/2022,Expense,297,Phil Coggan,,Work in Progress,"36,900.00","862,840.29"
,12/2/2022,Expense Transaction (Bank Draft),Mary1303,Natraj Publishers,,EastX ****2310,-395,"862,445.29"
,15/02/2022,Expense,418322,Aerial Direct,,MARKETING/SELLING:Telephone Expense,222.25,"862,667.54"
,15/02/2022,Expense,Proforma,The Birmingham Gun Barrel Proof House,,Cost of sales,900,"863,567.54"
,15/02/2022,Expense,17005,GWT Media,,ADMINISTRATION:Computer and Internet Expenses,45,"863,612.54"
,15/02/2022,Expense,JRC04,Mustard ties,,Stock / Inventory Asset,"3,772.80","867,385.34"
,15/02/2022,Expense,3576,Tweed Media,,MARKETING/SELLING:Marketing,"4,800.00","872,185.34"
,15/02/2022,Expense,341,IPS Gunmaking Ltd,,Cost of sales,300,"872,485.34"
,15/02/2022,Expense,,AXA Insurance,paid 21 Apr 2021,ADMINISTRATION:Insurance Expense,77.39,"872,562.73"
,15/02/2022,Expense,342,IPS Gunmaking Ltd,,-Split-,"2,420.00","874,982.73"
,15/02/2022,Expense,NI142899,Big Yellow Self Storage,,-Split-,"1,101.68","876,084.41"
,16/02/2022,Expense,2.10E+13,Raytrade UK Ltd,,-Split-,60,"876,144.41"
,16/02/2022,Expense,102502,SRS Freight Ltd,,MARKETING/SELLING:Postage and Delivery,626.33,"876,770.74"
,16/02/2022,Expense,H198008A15,eon,,ADMINISTRATION:Utilities,287.64,"877,058.38"
,16/02/2022,Expense,452,London Barrel Maker,,-Split-,"1,200.00","878,258.38"
,17/02/2022,Expense Transaction (Bank Draft),Mary1307,Parcelforce,,EastX ****2310,-219.9,"878,038.48"
,21/02/2022,Expense,1289,John Whitfield,,Cost of sales,800,"878,838.48"
,22/02/2022,Expense Transaction (Bank Draft),9269,Edmund Bbell & Co Ltd,,-Split-,,"878,838.48"
,22/02/2022,Expense Transaction (Bank Draft),Mary1310,SRS Freight Ltd,,EastX ****2310,"-14,494.66","864,343.82"
,22/02/2022,Expense Transaction (Bank Draft),Mary1312,Lothar Walther,,-Split-,,"864,343.82"
,22/02/2022,Expense Transaction (Bank Draft),Mary1311,Raytrade UK Ltd,,EastX ****2310,-60,"864,283.82"
,22/02/2022,Vendor Credit,,Edmund Bbell & Co Ltd,,Stock / Inventory Asset,"-1,353.26","862,930.56"
,22/02/2022,Expense,210202,Mayfair  Engineering,,-Split-,"8,976.00","871,906.56"
,22/02/2022,Expense,2021012,Ian Clarke,,-Split-,"4,441.50","876,348.06"
,22/02/2022,Expense,600494,Traditional English Guncases Ltd,,Cost of sales,"1,800.00","878,148.06"
,22/02/2022,Expense,600492,Traditional English Guncases Ltd,,Work in Progress,720,"878,868.06"
,22/02/2022,Expense,48,Ray St Ledger & Sons,,Cost of sales,48,"878,916.06"
,22/02/2022,Expense,210201,Mayfair  Engineering,,-Split-,"36,000.00","914,916.06"
,22/02/2022,Expense,121307,Genesis Labels,,-Split-,282.84,"915,198.90"
,22/02/2022,Expense,600491,Traditional English Guncases Ltd,,-Split-,"3,060.00","918,258.90"
,23/02/2022,Expense Transaction (Bank Draft),Mary1314,BF&D LIMITED,,EastX ****2310,"-1,200.00","917,058.90"
,23/02/2022,Expense,3182,ElS And Co (Pty) Ltd,,Stock / Inventory Asset,490,"917,548.90"
,23/02/2022,Expense Transaction (Bank Draft),Mary1320,GWT Media,,EastX ****2310,-878.4,"916,670.50"
,23/02/2022,Expense Transaction (Bank Draft),Mary1318,David E Josey,,EastX ****2310,"-2,000.00","914,670.50"
,23/02/2022,Expense Transaction (Bank Draft),Mary1315,Northwood Group UK Vendor,,EastX ****2310,"-16,736.00","897,934.50"
,23/02/2022,Expense Transaction (Bank Draft),Mary1286,Cooper Roberts,,EastX ****2310,-540,"897,394.50"
,23/02/2022,Expense Transaction (Bank Draft),Mary1322,Henry Krank,,EastX ****2310,-52.27,"897,342.23"
,23/02/2022,Expense Transaction (Bank Draft),Mary1321,Harper Office,,EastX ****2310,-67.2,"897,275.03"
,23/02/2022,Expense Transaction (Bank Draft),Mary1319,Dirty laundry,,EastX ****2310,-19.2,"897,255.83"
,23/02/2022,Expense Transaction (Bank Draft),Mary1316,Bronze Age Art Foundry Limited,,EastX ****2310,-942,"896,313.83"
,23/02/2022,Expense Transaction (Bank Draft),Mary1313,Beck Office,,EastX ****2310,-72,"896,241.83"
,23/02/2022,Expense Transaction (Bank Draft),Mary1312,Alan Rhone lTD,,EastX ****2310,-409.61,"895,832.22"
,23/02/2022,Expense Transaction (Bank Draft),Mary1328,Laser Welding Services,,EastX ****2310,-427.92,"895,404.30"
,23/02/2022,Expense Transaction (Bank Draft),Mary1323,Johnsons & Co Ltd,,EastX ****2310,"-2,100.00","893,304.30"
,23/02/2022,Expense Transaction (Bank Draft),Mary1329,Kynamco Limited,,EastX ****2310,"-1,637.40","891,666.90"
,23/02/2022,Expense Transaction (Bank Draft),Mary1327,Kerast,,EastX ****2310,"-1,376.40","890,290.50"
,23/02/2022,Expense Transaction (Bank Draft),Mary1317,Carrs Welding Technologies Ltd,,EastX ****2310,-350.1,"889,940.40"
,23/02/2022,Expense Transaction (Bank Draft),Mary1354,Cooper Roberts,,EastX ****2310,-540,"889,400.40"
,24/02/2022,Expense Transaction (Bank Draft),Mary1346,SNT Adventure Brands LLC,,EastX ****2310,-225.97,"889,174.43"
,24/02/2022,Expense,821,Musselbrook Machine Maintenance Ltd,,MARKETING/SELLING:Repair and maintenance,846,"890,020.43"
,24/02/2022,Expense Transaction (Bank Draft),Mary1333,Steve Kelly,,EastX ****2310,-456.48,"889,563.95"
,24/02/2022,Expense Transaction (Bank Draft),Mary1331,Manchester Automatic Machining,,EastX ****2310,-701.4,"888,862.55"
,24/02/2022,Expense Transaction (Bank Draft),Mary1358,London Barrel Maker,,EastX ****2310,"-5,400.00","883,462.55"
,24/02/2022,Expense Transaction (Bank Draft),Mary1357,A G Sinnett,,EastX ****2310,-80.63,"883,381.92"
,24/02/2022,Expense Transaction (Bank Draft),Mary1345,Julian & Sons,,EastX ****2310,-886.42,"882,495.50"
,24/02/2022,Expense Transaction (Bank Draft),Mary1339,Riflecraft Limited,,EastX ****2310,-325.8,"882,169.70"
,24/02/2022,Vendor Credit,,Karl Beier,,ADMINISTRATION:Exchange Rate cost,-14.44,"882,155.26"
,24/02/2022,Expense Transaction (Bank Draft),Mary1347,Karl Beier,,EastX ****2310,-965.71,"881,189.55"
,24/02/2022,Expense Transaction (Bank Draft),Mary1344,EXSTO Italia SRL,,EastX ****2310,-382.85,"880,806.70"
,24/02/2022,Expense Transaction (Bank Draft),Mary1343,Steve Helsley,,EastX ****2310,-671,"880,135.70"
,24/02/2022,Expense Transaction (Bank Draft),Mary1342,Recknagel,,EastX ****2310,-839.37,"879,296.33"
,24/02/2022,Expense Transaction (Bank Draft),Mary1341,Mustard ties,,EastX ****2310,"-3,772.80","875,523.53"
,24/02/2022,Expense Transaction (Bank Draft),Mary1341,Swarovski Optik,,-Split-,,"875,523.53"
,24/02/2022,Expense Transaction (Bank Draft),Mary1338,T & D O'Neill,,EastX ****2310,"-1,340.00","874,183.53"
,24/02/2022,Expense Transaction (Bank Draft),Mary1337,Mark Remmant,,EastX ****2310,-112,"874,071.53"
,24/02/2022,Expense Transaction (Bank Draft),Mary1336,TimberLake Workshop,,EastX ****2310,"-4,086.00","869,985.53"
,24/02/2022,Expense Transaction (Bank Draft),Mary1335,Rentokil,,EastX ****2310,-352.78,"869,632.75"
,24/02/2022,Expense Transaction (Bank Draft),Mary1334,Sharmic Engineering Limited,,EastX ****2310,-418.5,"869,214.25"
,24/02/2022,Expense Transaction (Bank Draft),Mary1332,Revolution Wines,,EastX ****2310,-24,"869,190.25"
,24/02/2022,Expense Transaction (Bank Draft),Mary1330,George Mudge & Co,,EastX ****2310,"-4,500.00","864,690.25"
,24/02/2022,Expense,24389,British Sporting Arms Ltd,Exchange rate £1 = $1.4087,Shipping & Freight,"17,207.35","881,897.60"
,24/02/2022,Expense,1656,TimberLake Workshop,,-Split-,102,"881,999.60"
,24/02/2022,Expense,,Steve Helsley,,ADMINISTRATION:Bank & card charges,15,"882,014.60"
,24/02/2022,Expense,44207,The Company of Gunmakers,,-Split-,92.56,"882,107.16"
,24/02/2022,Expense,818,Musselbrook Machine Maintenance Ltd,,MARKETING/SELLING:Repair and maintenance,432,"882,539.16"
,24/02/2022,Expense Transaction (Bank Draft),Mary1340,Swarovski Optik,,EastX ****2310,-935.17,"881,603.99"
,25/02/2022,Expense,5733,Beck Office,,Bookkeeping & Payroll,72,"881,675.99"
,25/02/2022,Vendor Credit,,Traditional Fine Engraving,,ADMINISTRATION:Exchange Rate cost,-208.07,"881,467.92"
,25/02/2022,Expense Transaction (Bank Draft),Mary1359,Traditional Fine Engraving,,EastX ****2310,"-8,820.43","872,647.49"
,25/02/2022,Expense,59551,George Mudge & Co,,MARKETING/SELLING:Postage and Delivery,300,"872,947.49"
,25/02/2022,Expense Transaction (Bank Draft),9272,ElS And Co (Pty) Ltd,,EastX Bank,-490,"872,457.49"
,25/02/2022,Expense Transaction (Bank Draft),Mary1348,Genesis Labels,,EastX ****2310,-282.84,"872,174.65"
,25/02/2022,Expense,,Charles Langmead,,Stock / Inventory Asset,200,"872,374.65"
,25/02/2022,Expense Transaction (Bank Draft),Mary1350,Ian Clarke,,EastX ****2310,"-4,441.50","867,933.15"
,26/02/2022,Expense,,A G Sinnett,,-Split-,80.63,"868,013.78"
,26/02/2022,Expense,,Propel Finance No 1,,MARKETING/SELLING:Telephone Expense,218.16,"868,231.94"
,26/02/2022,Expense,26/05/4276,Giclee UK Ltd,,-Split-,932,"869,163.94"
,26/02/2022,Expense,24393,British Sporting Arms Ltd,£1 = $1.4087,Shipping & Freight,922.13,"870,086.07"
,26/02/2022,Expense,70691,Harper Office,,ADMINISTRATION:Office Supplies,267.6,"870,353.67"
,26/02/2022,Expense,3189,ElS And Co (Pty) Ltd,,Stock / Inventory Asset,144,"870,497.67"
,26/02/2022,Expense Transaction (Bank Draft),Mary1362,Sage UK Limited,,EastX ****2310,"-1,189.03","869,308.64"
,26/02/2022,Expense Transaction (Bank Draft),Mary1360,George Mudge & Co,,EastX ****2310,-300,"869,008.64"
,26/02/2022,Expense Transaction (Bank Draft),Mary1363,Aerial Direct,,EastX ****2310,-222.25,"868,786.39"
,26/02/2022,Expense,75064,Kerast,,-Split-,492.6,"869,278.99"
,26/02/2022,Expense Transaction (Bank Draft),Mary1361,Tweed Media,,EastX ****2310,"-4,800.00","864,478.99"
,28/02/2022,Vendor Credit,,ARC,,ADMINISTRATION:Office Supplies,-0.76,"864,478.23"
,28/02/2022,Expense Transaction (Bank Draft),781,Cooksongold,,Business Card,-135.73,"864,342.50"
,28/02/2022,Expense Transaction (Bank Draft),774,Industrial Boilerhouse Supplies Ltd,,Business Card,-762,"863,580.50"
,28/02/2022,Expense Transaction (Bank Draft),778,ARC,,-Split-,,"863,580.50"
,28/02/2022,Expense,GD0221,Northwood USA,£1 = $1.4087,MARKETING/SELLING:Consultants,"6,025.44","869,605.94"
,28/02/2022,Expense,,Northwood Group,,Shared cost,"2,636.50","872,242.44"
,28/02/2022,Expense,Q69883,Quest Freight Limited,,Shipping & Freight,484.05,"872,726.49"
,28/02/2022,Expense,,L & O Immobilien GMBH & Co KG,,ADMINISTRATION:Rent & Rates Expense,"10,666.12","883,392.61"
,28/02/2022,Expense,,Northwood Group,,Shared cost,"1,015.00","884,407.61"
,1/3/2022,Expense Transaction (Bank Draft),Mary1373,Harper Office,,EastX ****2310,-267.6,"884,140.01"
,1/3/2022,Expense,05183/IA,Knighthood International Security Ltd,,MARKETING/SELLING:Repair and maintenance,636,"884,776.01"
,1/3/2022,Expense Transaction (Bank Draft),Mary1371,Propel Finance No 1,,EastX ****2310,-218.16,"884,557.85"
,1/3/2022,Expense Transaction (Bank Draft),771,The Birmingham Gun Barrel Proof House,,Business Card,-900,"883,657.85"
,1/3/2022,Expense,600500,Traditional English Guncases Ltd,,Stock / Inventory Asset,"1,872.00","885,529.85"
,1/3/2022,Expense,695228,Jay Spark Co Ltd,,-Split-,101.45,"885,631.30"
,1/3/2022,Expense,695537,Jay Spark Co Ltd,,Cost of sales,28.83,"885,660.13"
,1/3/2022,Expense,600499,Traditional English Guncases Ltd,,-Split-,"3,600.00","889,260.13"
,1/3/2022,Expense,44230,Buck's Club Limited,,-Split-,241.25,"889,501.38"
,1/3/2022,Expense,109489-1,BrandCo Branding Ltd,,Materials & Tools,318.19,"889,819.57"
,1/3/2022,Expense,143295277,Worldpay,,ADMINISTRATION:Bank & card charges,61.34,"889,880.91"
,1/3/2022,Expense,1322,Broadbent Leather goods,,-Split-,106.5,"889,987.41"
,1/3/2022,Expense,2.01E+13,Henry Krank,,-Split-,206,"890,193.41"
,1/3/2022,Expense,210301,Mayfair  Engineering,,Stock / Inventory Asset,76.8,"890,270.21"
,1/3/2022,Expense,1284,Broadbent Leather goods,,Cost of sales,56.4,"890,326.61"
,1/3/2022,Expense,17065,GWT Media,,ADMINISTRATION:Computer and Internet Expenses,210.6,"890,537.21"
,1/3/2022,Expense,05183/AC,Knighthood International Security Ltd,,MARKETING/SELLING:Repair and maintenance,150,"890,687.21"
,1/3/2022,Expense,11902,J Roberts & Son Ltd,,-Split-,174,"890,861.21"
,1/3/2022,Expense,144,Fox & Co Bespokw Ltd,,-Split-,204,"891,065.21"
,1/3/2022,Expense,204371681,UPS,,MARKETING/SELLING:Postage and Delivery,408.5,"891,473.71"
,1/3/2022,Expense Transaction (Bank Draft),Mary1372,Big Yellow Self Storage,,EastX ****2310,"-1,101.68","890,372.03"
,2/3/2022,Expense Transaction (Bank Draft),9275,Northwood Group Wetzlar,,EastX Bank,"-33,685.69","856,686.34"
,2/3/2022,Expense Transaction (Bank Draft),Mary1351,Mayfair  Engineering,,EastX ****2310,"-20,000.00","836,686.34"
,2/3/2022,Expense,05183/CC,Knighthood International Security Ltd,,MARKETING/SELLING:Repair and maintenance,138,"836,824.34"
,2/3/2022,Expense,Q69884,Quest Freight Limited,,Shipping & Freight,371.9,"837,196.24"
,2/3/2022,Expense,17162,GWT Media,,ADMINISTRATION:Computer and Internet Expenses,135,"837,331.24"
,2/3/2022,Expense Transaction (Bank Draft),9276,Mauser Jagdwaffen,,EastX Bank,"-32,016.05","805,315.19"
,3/3/2022,Expense Transaction (Bank Draft),Mary1376,SonySports Press Limited,,EastX ****2310,"-1,794.00","803,521.19"
,3/3/2022,Expense,6637,Field Sports Publishing Inc,£1 = $1.35,MARKETING/SELLING:Advertising/Promotional,"2,814.80","806,335.99"
,3/3/2022,Expense Transaction (Bank Draft),9277,eon,,EastX Bank,-287.64,"806,048.35"
,3/3/2022,Expense Transaction (Bank Draft),Mary1375,Field Sports Publishing Inc,,EastX ****2310,"-2,803.72","803,244.63"
,3/3/2022,Expense,,Field Sports Publishing Inc,,ADMINISTRATION:Exchange Rate cost,21.6,"803,266.23"
,3/3/2022,Expense,,AXA Insurance,,ADMINISTRATION:Exchange Rate cost,17.2,"803,283.43"
,3/3/2022,Expense,R17-04-48,IDR Associates,,-Split-,"1,366.20","804,649.63"
,3/3/2022,Expense,1943,Curious Book,,-Split-,720,"805,369.63"
,3/3/2022,Expense,1001/00074283,Edgar Brothers,,-Split-,840.92,"806,210.55"
,3/3/2022,Expense,1739,A T Miles,,-Split-,"1,380.00","807,590.55"
,3/3/2022,Expense,R17-04-46,IDR Associates,,-Split-,423.6,"808,014.15"
,3/3/2022,Expense,R17-04-47,IDR Associates,,-Split-,647.4,"808,661.55"
,3/3/2022,Expense,Ancient13,Dirty laundry,,ADMINISTRATION:Cleaning Supplies,19.2,"808,680.75"
,3/3/2022,Expense,30165981101,ARAMEX,,MARKETING/SELLING:Postage and Delivery,177.85,"808,858.60"
,3/3/2022,Expense,21-018/Schi,Firma Alfred Schilling,,-Split-,445.44,"809,304.04"
,3/3/2022,Expense Transaction (Bank Draft),9290,Northwood Group,,EastX Bank,"-50,000.00","759,304.04"
,4/3/2022,Expense,65522,ARC,,ADMINISTRATION:Office Supplies,51.91,"759,355.95"
,5/3/2022,Expense Transaction (Bank Draft),9279,AXA Insurance,,EastX Bank,-945.65,"758,410.30"
,7/3/2022,Expense,109606,CJB Engineering,,-Split-,"4,920.00","763,330.30"
,8/3/2022,Expense Transaction (Bank Draft),Mary1384,Firma Alfred Schilling,,EastX ****2310,-445.44,"762,884.86"
,8/3/2022,Expense Transaction (Bank Draft),Mary1383,Ian Clarke,,EastX ****2310,"-1,478.34","761,406.52"
,8/3/2022,Expense Transaction (Bank Draft),Mary1378,Traditional English Guncases Ltd,,EastX ****2310,"-14,040.00","747,366.52"
,8/3/2022,Expense Transaction (Bank Draft),Mary1370,British Sporting Arms Ltd,,EastX ****2310,"-17,862.66","729,503.86"
,8/3/2022,Expense Transaction (Bank Draft),Mary1369,British Sporting Arms Ltd,,EastX ****2310,-974.89,"728,528.97"
,8/3/2022,Expense,2021015,Ian Clarke,,-Split-,"1,478.34","730,007.31"
,8/3/2022,Expense,,British Sporting Arms Ltd,,ADMINISTRATION:Exchange Rate cost,655.31,"730,662.62"
,8/3/2022,Expense,,British Sporting Arms Ltd,,ADMINISTRATION:Exchange Rate cost,52.76,"730,715.38"
,8/3/2022,Expense,21004387,Ben Becker,,MARKETING/SELLING:Postage and Delivery,325.82,"731,041.20"
,8/3/2022,Expense,9501,The Print Factory,,-Split-,750,"731,791.20"
,8/3/2022,Expense Transaction (Bank Draft),9280,L & O Immobilien GMBH & Co KG,,EastX Bank,"-10,666.11","721,125.09"
,9/3/2022,Expense Transaction (Bank Draft),795,Mike Ball,,Business Card,-732.7,"720,392.39"
,9/3/2022,Expense Transaction (Bank Draft),Mary1379,Mayfair  Engineering,,EastX ****2310,"-24,976.00","695,416.39"
,9/3/2022,Expense Transaction (Bank Draft),Mary1380,Rodl & Partner,,EastX ****2310,"-1,080.00","694,336.39"
,9/3/2022,Expense,,Jerome  Lannoue,,-Split-,"1,145.03","695,481.42"
,9/3/2022,Expense,44229,The Company of Gunmakers,,-Split-,151.96,"695,633.38"
,9/3/2022,Expense,DVI102557,SRS Freight Ltd,,MARKETING/SELLING:Postage and Delivery,141.88,"695,775.26"
,9/3/2022,Expense,INV102558,SRS Freight Ltd,,MARKETING/SELLING:Postage and Delivery,341.5,"696,116.76"
,9/3/2022,Expense,1107,London Property Inspections,,MARKETING/SELLING:Misc,500,"696,616.76"
,10/3/2022,Expense Transaction (Bank Draft),Mary1386,ARAMEX,,EastX ****2310,-177.85,"696,438.91"
,10/3/2022,Expense Transaction (Bank Draft),Mary1388,Jamie,,EastX ****2310,-364.36,"696,074.55"
,10/3/2022,Expense,,William Wild,,-Split-,"5,100.00","701,174.55"
,10/3/2022,Expense,983,T F Wood & Son,,-Split-,"3,602.00","704,776.55"
,10/3/2022,Expense,,Jamie,,-Split-,364.36,"705,140.91"
,10/3/2022,Expense,2021/044,Top Blades International,,-Split-,"3,483.00","708,623.91"
,10/3/2022,Expense,,WORKMAN EDWARD,,-Split-,931.01,"709,554.92"
,10/3/2022,Expense,29,Steve Kelly,,-Split-,"2,500.00","712,054.92"
,11/3/2022,Expense Transaction (Bank Draft),Mary1382,Henry Krank,,EastX ****2310,-206,"711,848.92"
,11/3/2022,Expense,INV62078,ASIC S A of Switzerland,,Materials & Tools,"1,157.14","713,006.06"
,11/3/2022,Expense,1001/00074827,Edgar Brothers,,Cost of sales,"1,243.08","714,249.14"
,11/3/2022,Expense Transaction (Bank Draft),Mary1381,Quest Freight Limited,,EastX ****2310,-855.95,"713,393.19"
,12/3/2022,Expense,24426,British Sporting Arms Ltd,£1 = $1.39,Cost of sales,"4,700.65","718,093.84"
,13/03/2022,Expense,80144500,LAMBETH,,ADMINISTRATION:Office Cleaning,160.65,"718,254.49"
,15/03/2022,Expense Transaction (Bank Draft),Mary1389,Charles Langmead,,EastX ****2310,-200,"718,054.49"
,15/03/2022,Expense Transaction (Bank Draft),Mary1424,British Sporting Arms Ltd,,EastX ****2310,"-4,700.65","713,353.84"
,15/03/2022,Expense Transaction (Bank Draft),Mary1423,SRS Freight Ltd,,EastX ****2310,"-4,055.36","709,298.48"
,15/03/2022,Expense,INV102569,SRS Freight Ltd,,MARKETING/SELLING:Postage and Delivery,85,"709,383.48"
,15/03/2022,Expense,600502,Traditional English Guncases Ltd,,Stock / Inventory Asset,"1,260.00","710,643.48"
,15/03/2022,Expense,9062613080,Parcelforce,,MARKETING/SELLING:Postage and Delivery,21.96,"710,665.44"
,15/03/2022,Expense,931,SonySports Press Limited,,MARKETING/SELLING:Marketing,"1,794.00","712,459.44"
,15/03/2022,Expense,,Barton Gun Work,,-Split-,257.76,"712,717.20"
,15/03/2022,Expense,INV102568,SRS Freight Ltd,,MARKETING/SELLING:Postage and Delivery,418,"713,135.20"
,15/03/2022,Expense,,David E Josey,,Work in Progress,"2,000.00","715,135.20"
,15/03/2022,Expense,3588,Tweed Media,,MARKETING/SELLING:Marketing,"4,800.00","719,935.20"
,15/03/2022,Expense,419364,Aerial Direct,,MARKETING/SELLING:Telephone Expense,221.86,"720,157.06"
,15/03/2022,Expense,DVI102567,SRS Freight Ltd,,MARKETING/SELLING:Postage and Delivery,"4,055.36","724,212.42"
,17/03/2022,Expense,26272,Pat Central,,MARKETING/SELLING:Repair and maintenance,188.4,"724,400.82"
,17/03/2022,Expense,OP/I763517,GMK,,-Split-,166.8,"724,567.62"
,17/03/2022,Expense,,A G Sinnett,,-Split-,264.39,"724,832.01"
,18/03/2022,Expense,H199CAB5F7,eon,,ADMINISTRATION:Utilities,47.12,"724,879.13"
,18/03/2022,Expense,H199CA7516,eon,,ADMINISTRATION:Utilities,77.64,"724,956.77"
,18/03/2022,Expense,OP/I1763624,GMK,,Cost of sales,"1,458.00","726,414.77"
,18/03/2022,Expense,H199CA752B,eon,,ADMINISTRATION:Utilities,317.89,"726,732.66"
,18/03/2022,Expense,49,IDR Associates,,-Split-,"1,096.76","727,829.42"
,18/03/2022,Expense,NI143888,Big Yellow Self Storage,,-Split-,"1,132.88","728,962.30"
,18/03/2022,Expense,50,IDR Associates,,-Split-,652.39,"729,614.69"
,19/03/2022,Expense,51,IDR Associates,,-Split-,"5,566.51","735,181.20"
,19/03/2022,Expense,62097,ASIC S A of Switzerland,,Stock / Inventory Asset,"2,897.20","738,078.40"
,22/03/2022,Expense Transaction (Bank Draft),Mary1394,Beck Office,,EastX ****2310,-72,"738,006.40"
,22/03/2022,Expense,9062648278,Parcelforce,,MARKETING/SELLING:Postage and Delivery,175.46,"738,181.86"
,22/03/2022,Expense Transaction (Bank Draft),Mary1392,ARC,,EastX ****2310,-84.82,"738,097.04"
,22/03/2022,Expense Transaction (Bank Draft),Mary1391,A T Miles,,EastX ****2310,"-1,380.00","736,717.04"
,22/03/2022,Expense Transaction (Bank Draft),Mary1412,Musselbrook Machine Maintenance Ltd,,EastX ****2310,"-1,278.00","735,439.04"
,22/03/2022,Expense Transaction (Bank Draft),Mary1410,London Barrel Maker,,EastX ****2310,"-1,200.00","734,239.04"
,22/03/2022,Expense Transaction (Bank Draft),Mary1408,John Whitfield,,EastX ****2310,-800,"733,439.04"
,22/03/2022,Expense Transaction (Bank Draft),Mary1407,Jay Spark Co Ltd,,EastX ****2310,-130.28,"733,308.76"
,22/03/2022,Expense Transaction (Bank Draft),Mary1397,Edgar Brothers,,EastX ****2310,"-2,084.00","731,224.76"
,22/03/2022,Expense Transaction (Bank Draft),Mary1390,Steve Kelly,,EastX ****2310,"-2,500.00","728,724.76"
,22/03/2022,Expense Transaction (Bank Draft),Mary1418,William Wild,,EastX ****2310,"-5,100.00","723,624.76"
,22/03/2022,Expense Transaction (Bank Draft),Mary1417,The Print Factory,,EastX ****2310,-750,"722,874.76"
,22/03/2022,Expense Transaction (Bank Draft),Mary1416,The Company of Gunmakers,,EastX ****2310,-232.52,"722,642.24"
,22/03/2022,Expense Transaction (Bank Draft),Mary1415,Ray St Ledger & Sons,,EastX ****2310,-48,"722,594.24"
,22/03/2022,Expense Transaction (Bank Draft),Mary1414,Kerast,,EastX ****2310,-492.6,"722,101.64"
,22/03/2022,Expense Transaction (Bank Draft),Mary1427,Pat Central,,EastX ****2310,-188.4,"721,913.24"
,22/03/2022,Expense Transaction (Bank Draft),Mary1426,A G Sinnett,,EastX ****2310,-264.39,"721,648.85"
,22/03/2022,Expense Transaction (Bank Draft),Mary1413,SRS Freight Ltd,,EastX ****2310,"-4,956.74","716,692.11"
,22/03/2022,Expense Transaction (Bank Draft),Mary1411,Mayfair  Engineering,,EastX ****2310,-76.8,"716,615.31"
,22/03/2022,Expense Transaction (Bank Draft),Mary1409,Knighthood International Security Ltd,,EastX ****2310,-924,"715,691.31"
,22/03/2022,Expense Transaction (Bank Draft),Mary1406,J Roberts & Son Ltd,,EastX ****2310,-174,"715,517.31"
,22/03/2022,Expense Transaction (Bank Draft),Mary1405,IPS Gunmaking Ltd,,EastX ****2310,"-2,720.00","712,797.31"
,22/03/2022,Expense Transaction (Bank Draft),Mary1404,IDR Associates,,EastX ****2310,"-1,366.20","711,431.11"
,22/03/2022,Expense Transaction (Bank Draft),Mary1403,IDR Associates,,EastX ****2310,-647.4,"710,783.71"
,22/03/2022,Expense Transaction (Bank Draft),Mary1402,IDR Associates,,EastX ****2310,-423.6,"710,360.11"
,22/03/2022,Expense Transaction (Bank Draft),Mary1401,GWT Media,,EastX ****2310,-345.6,"710,014.51"
,22/03/2022,Expense Transaction (Bank Draft),Mary1400,Giclee UK Ltd,,EastX ****2310,-932,"709,082.51"
,22/03/2022,Expense Transaction (Bank Draft),Mary1399,Fox & Co Bespokw Ltd,,EastX ****2310,-204,"708,878.51"
,22/03/2022,Expense Transaction (Bank Draft),Mary1398,TimberLake Workshop,,EastX ****2310,-102,"708,776.51"
,22/03/2022,Expense Transaction (Bank Draft),Mary1396,Dirty laundry,,EastX ****2310,-19.2,"708,757.31"
,22/03/2022,Expense Transaction (Bank Draft),Mary1395,Curious Book,,EastX ****2310,-720,"708,037.31"
,22/03/2022,Expense Transaction (Bank Draft),Mary1393,ARC,,EastX ****2310,-10,"708,027.31"
,23/03/2022,Expense Transaction (Bank Draft),Mary1431,Mark Remmant,,EastX ****2310,-170,"707,857.31"
,23/03/2022,Expense Transaction (Bank Draft),Mary1434,Parcelforce,,EastX ****2310,-397.85,"707,459.46"
,23/03/2022,Expense Transaction (Bank Draft),Mary1428,T F Wood & Son,,EastX ****2310,"-3,602.00","703,857.46"
,23/03/2022,Expense Transaction (Bank Draft),Mary1422,Purdey,,EastX ****2310,"-3,300.00","700,557.46"
,23/03/2022,Expense,,Mark Remmant,,-Split-,170,"700,727.46"
,23/03/2022,Expense,3224,ElS And Co (Pty) Ltd,,-Split-,"4,154.00","704,881.46"
,23/03/2022,Expense,3225,ElS And Co (Pty) Ltd,,Stock / Inventory Asset,369,"705,250.46"
,23/03/2022,Expense,,Parcelforce,,MARKETING/SELLING:Postage and Delivery,231.69,"705,482.15"
,23/03/2022,Expense,1158JRL,Laser Welding Services,,-Split-,"1,339.92","706,822.07"
,24/03/2022,Expense Transaction (Bank Draft),Mary1444,Davis and Gold Limited,,EastX ****2310,-110,"706,712.07"
,24/03/2022,Expense,1291,John Whitfield,,MARKETING/SELLING:Marketing,880,"707,592.07"
,24/03/2022,Expense,30782,Davis and Gold Limited,,MARKETING/SELLING:Repair and maintenance,110,"707,702.07"
,24/03/2022,Expense,888,Musselbrook Machine Maintenance Ltd,,MARKETING/SELLING:Repair and maintenance,668.16,"708,370.23"
,25/03/2022,Expense,Rig001,Ian Moran,,-Split-,"3,500.00","711,870.23"
,25/03/2022,Expense,1292,John Whitfield,,MARKETING/SELLING:Marketing,580,"712,450.23"
,25/03/2022,Expense,70898,Harper Office,,ADMINISTRATION:Office Supplies,626.3,"713,076.53"
,25/03/2022,Expense,5782,Beck Office,,Bookkeeping & Payroll,72,"713,148.53"
,25/03/2022,Expense,70897,Harper Office,,ADMINISTRATION:Office Supplies,74.39,"713,222.92"
,26/03/2022,Expense,1164JRL,Laser Welding Services,,-Split-,135.18,"713,358.10"
,26/03/2022,Expense,,ElS And Co (Pty) Ltd,,ADMINISTRATION:Exchange Rate cost,52.59,"713,410.69"
,26/03/2022,Expense,6569,GD Machinery Ltd,,Materials & Tools,300,"713,710.69"
,26/03/2022,Expense,44268,The Company of Gunmakers,,Work in Progress,59.4,"713,770.09"
,29/03/2022,Expense Transaction (Bank Draft),Mary1430,London Property Inspections,,EastX ****2310,-500,"713,270.09"
,29/03/2022,Expense Transaction (Bank Draft),Mary1443,Aerial Direct,,EastX ****2310,-221.86,"713,048.23"
,29/03/2022,Expense,16925,Aform Tooling Limited,,-Split-,"1,070.40","714,118.63"
,29/03/2022,Expense Transaction (Bank Draft),Mary1438,GD Machinery Ltd,,EastX ****2310,-300,"713,818.63"
,29/03/2022,Expense Transaction (Bank Draft),Mary1439,Tweed Media,,EastX ****2310,"-4,800.00","709,018.63"
,30/03/2022,Expense,102606,SRS Freight Ltd,,Cost of sales,"2,712.50","711,731.13"
,30/03/2022,Expense,66088,ARC,,ADMINISTRATION:Office Supplies,42.26,"711,773.39"
,31/03/2022,Expense Transaction (Bank Draft),Mary1429,Phil Coggan,,EastX ****2310,"-36,900.00","674,873.39"
,31/03/2022,Expense,,Northwood USA,£1 = $1.1725,MARKETING/SELLING:Consultants,"7,751.42","682,624.81"
,31/03/2022,Expense,,Northwood Group,,Shared cost,"1,015.00","683,639.81"
,31/03/2022,Expense,,Northwood Group,,Shared cost,"2,636.50","686,276.31"
,31/03/2022,Expense,698327,Jay Spark Co Ltd,,-Split-,55.27,"686,331.58"
,31/03/2022,Expense,2021/049,Northwood Group,,-Split-,"27,846.00","714,177.58"
,31/03/2022,Expense,70999,Harper Office,,ADMINISTRATION:Office Supplies,"1,081.20","715,258.78"
,31/03/2022,Expense,52189,Knighthood International Security Ltd,,MARKETING/SELLING:Repair and maintenance,156,"715,414.78"
,1/4/2022,Expense Transaction (Bank Draft),Mary1448,Jerome  Lannoue,,EastX ****2310,-733.2,"714,681.58"
,1/4/2022,Expense,,Kerast,,-Split-,234,"714,915.58"
,1/4/2022,Expense Transaction (Bank Draft),Mary1460,Beck Office,,EastX ****2310,-72,"714,843.58"
,1/4/2022,Expense Transaction (Bank Draft),Mary1459,Ben Becker,,EastX ****2310,-325.82,"714,517.76"
,1/4/2022,Expense Transaction (Bank Draft),Mary1455,David E Josey,,EastX ****2310,"-2,000.00","712,517.76"
,1/4/2022,Expense Transaction (Bank Draft),Mary1451,LAMBETH,,EastX ****2310,-160.65,"712,357.11"
,1/4/2022,Expense Transaction (Bank Draft),Mary1449,Jerome  Lannoue,,EastX ****2310,-443.19,"711,913.92"
,1/4/2022,Expense Transaction (Bank Draft),Mary1488,Big Yellow Self Storage,,EastX ****2310,"-1,132.88","710,781.04"
,1/4/2022,Expense Transaction (Bank Draft),Mary1457,Buck's Club Limited,,EastX ****2310,-241.25,"710,539.79"
,1/4/2022,Expense Transaction (Bank Draft),Mary1452,WORKMAN EDWARD,,EastX ****2310,-931.01,"709,608.78"
,1/4/2022,Expense Transaction (Bank Draft),9293,ElS And Co (Pty) Ltd,,EastX Bank,"-4,719.59","704,889.19"
,1/4/2022,Expense Transaction (Bank Draft),Mary1458,Broadbent Leather goods,,EastX ****2310,-162.9,"704,726.29"
,1/4/2022,Expense Transaction (Bank Draft),Mary1447,Top Blades International,,EastX ****2310,"-2,735.00","701,991.29"
,1/4/2022,Expense Transaction (Bank Draft),9297,L & O Immobilien GMBH & Co KG,,EastX Bank,"-10,666.11","691,325.18"
,1/4/2022,Expense Transaction (Bank Draft),Mary1456,CJB Engineering,,EastX ****2310,"-4,920.00","686,405.18"
,1/4/2022,Expense Transaction (Bank Draft),Mary1454,GMK,,EastX ****2310,"-1,624.80","684,780.38"
,1/4/2022,Expense Transaction (Bank Draft),Mary1453,Harper Office,,EastX ****2310,-700.69,"684,079.69"
,1/4/2022,Expense Transaction (Bank Draft),Mary1450,John Whitfield,,EastX ****2310,"-1,460.00","682,619.69"
,1/4/2022,Expense,1618,Helston Gunsmiths,,-Split-,365.4,"682,985.09"
,1/4/2022,Expense,Order 241146,Lothar Walther,,-Split-,186.82,"683,171.91"
,1/4/2022,Expense,JRC05,Mustard ties,,-Split-,37.2,"683,209.11"
,1/4/2022,Expense,,The Butcher & Larder,,MARKETING/SELLING:Subsistasnce and Entertainment expenses,176.2,"683,385.31"
,1/4/2022,Expense,600506,Traditional English Guncases Ltd,,-Split-,"14,400.00","697,785.31"
,1/4/2022,Expense,,Jerome  Lannoue,,-Split-,"1,461.31","699,246.62"
,1/4/2022,Expense,698055,Jay Spark Co Ltd,,-Split-,117.76,"699,364.38"
,1/4/2022,Expense,1619,Helston Gunsmiths,,Stock / Inventory Asset,366,"699,730.38"
,1/4/2022,Expense,SLDI299005,Cargo Overseas Limited,,MARKETING/SELLING:Postage and Delivery,75,"699,805.38"
,1/4/2022,Expense,600483,Traditional English Guncases Ltd,,-Split-,"3,600.00","703,405.38"
,1/4/2022,Expense,8400023052,Northwood Group,,Cost of sales,841.34,"704,246.72"
,1/4/2022,Expense,2753,Julian & Sons,,Storage,903.61,"705,150.33"
,1/4/2022,Expense,17233,GWT Media,,ADMINISTRATION:Computer and Internet Expenses,207,"705,357.33"
,1/4/2022,Expense,1136,Cooper Roberts,,Storage,270,"705,627.33"
,1/4/2022,Expense,414862,P Higgins & Sons Ltd,,-Split-,"2,400.00","708,027.33"
,1/4/2022,Expense,,L & O Immobilien GMBH & Co KG,,ADMINISTRATION:Rent & Rates Expense,"10,666.11","718,693.44"
,1/4/2022,Expense,SLTI299010,Cargo Overseas Limited,,MARKETING/SELLING:Postage and Delivery,570,"719,263.44"
,1/4/2022,Expense,,Excelmate,,MARKETING/SELLING:Professional Fees,70,"719,333.44"
,1/4/2022,Expense,1688,TimberLake Workshop,,-Split-,590.4,"719,923.84"
,1/4/2022,Expense,20-Feb,dr. E. Stief - Jagdwaffen,Expense dated 2nd Sep 2020,Stock / Inventory Asset,"8,002.69","727,926.53"
,1/4/2022,Expense,600482,Traditional English Guncases Ltd,,Stock / Inventory Asset,30,"727,956.53"
,1/4/2022,Expense,75272,Kerast,,-Split-,950.4,"728,906.93"
,1/4/2022,Expense,,T & D O'Neill,,-Split-,320,"729,226.93"
,1/4/2022,Expense,,Firma Alfred Schilling,,Work in Progress,286.09,"729,513.02"
,1/4/2022,Expense,49608857,UPS,,MARKETING/SELLING:Postage and Delivery,41.53,"729,554.55"
,1/4/2022,Expense,2411890,Cooksongold,,Stock / Inventory Asset,"2,261.83","731,816.38"
,1/4/2022,Expense,SLTI299003,Cargo Overseas Limited,,MARKETING/SELLING:Postage and Delivery,65,"731,881.38"
,1/4/2022,Expense Transaction (Bank Draft),Mary1462,ASIC S A of Switzerland,,EastX ****2310,"-1,157.14","730,724.24"
,3/4/2022,Expense,Ancient14,Dirty laundry,,ADMINISTRATION:Cleaning Supplies,38.4,"730,762.64"
,4/4/2022,Expense,,Top Blades International,,ADMINISTRATION:Bank & card charges,15,"730,777.64"
,4/4/2022,Expense,,Jerome  Lannoue,,ADMINISTRATION:Bank & card charges,16.36,"730,794.00"
,4/4/2022,Expense,,Barton Gun Work,,-Split-,257.76,"731,051.76"
,5/4/2022,Expense Transaction (Bank Draft),9294,eon,,EastX Bank,-77.64,"730,974.12"
,5/4/2022,Expense Transaction (Bank Draft),9295,eon,,EastX Bank,-317.89,"730,656.23"
,5/4/2022,Expense,,T & D O'Neill,,-Split-,360,"731,016.23"
,5/4/2022,Expense,,T & D O'Neill,,-Split-,470,"731,486.23"
,5/4/2022,Expense,,T & D O'Neill,,MARKETING/SELLING:Postage and Delivery,190,"731,676.23"
,5/4/2022,Expense,,T & D O'Neill,,MARKETING/SELLING:Postage and Delivery,230,"731,906.23"
,6/4/2022,Expense Transaction (Bank Draft),9292,Northwood Group,,EastX Bank,"-50,000.00","681,906.23"
,6/4/2022,Expense Transaction (Bank Draft),Mary1464,Julian & Sons,,EastX ****2310,-903.61,"681,002.62"
,6/4/2022,Expense Transaction (Bank Draft),Mary1463,eon,,EastX ****2310,-47.12,"680,955.50"
,6/4/2022,Expense,21211284,Swarovski Optik,,Work in Progress,"1,666.50","682,622.00"
,6/4/2022,Expense,343,IPS Gunmaking Ltd,,-Split-,"6,131.00","688,753.00"
,6/4/2022,Expense,,Jerome  Lannoue,,ADMINISTRATION:Bank & card charges,15,"688,768.00"
,6/4/2022,Expense,146635927,Worldpay,,ADMINISTRATION:Bank & card charges,"1,704.78","690,472.78"
,6/4/2022,Expense,R17-04-52,IDR Associates,,-Split-,"2,099.71","692,572.49"
,6/4/2022,Expense,66212,ARC,,ADMINISTRATION:Office Supplies,37.88,"692,610.37"
,7/4/2022,Expense,455,London Barrel Maker,,Work in Progress,"3,000.00","695,610.37"
,7/4/2022,Expense Transaction (Bank Draft),Mary1466,Top Blades International,,EastX ****2310,-763,"694,847.37"
,8/4/2022,Expense,,Ray St Ledger & Sons,,Cost of sales,"1,474.80","696,322.17"
,8/4/2022,Expense,149,Nigel Westway,,Work in Progress,"5,500.00","701,822.17"
,9/4/2022,Expense,210402,Mayfair  Engineering,,Work in Progress,"3,582.00","705,404.17"
,9/4/2022,Expense,71098,Harper Office,,ADMINISTRATION:Office Supplies,68.06,"705,472.23"
,9/4/2022,Expense,210401,Mayfair  Engineering,,Work in Progress,"3,582.00","709,054.23"
,9/4/2022,Expense,Proforma,Star Lapel Pin Co. Ltd,,Stock / Inventory Asset,123.7,"709,177.93"
,12/4/2022,Expense,698942,Jay Spark Co Ltd,,-Split-,21.86,"709,199.79"
,12/4/2022,Expense,9062774385,Parcelforce,,-Split-,252.45,"709,452.24"
,12/4/2022,Expense,II2414332,Cooksongold,,Cost of sales,394.42,"709,846.66"
,13/04/2022,Expense Transaction (Bank Draft),Mary1482,The Company of Gunmakers,,EastX ****2310,-59.4,"709,787.26"
,13/04/2022,Expense,,Jamie,,-Split-,365.84,"710,153.10"
,13/04/2022,Expense Transaction (Bank Draft),Mary1480,P Higgins & Sons Ltd,,EastX ****2310,"-2,400.00","707,753.10"
,13/04/2022,Expense Transaction (Bank Draft),Mary1470,Cargo Overseas Limited,,EastX ****2310,-710,"707,043.10"
,13/04/2022,Expense Transaction (Bank Draft),Mary1476,Knighthood International Security Ltd,,EastX ****2310,-156,"706,887.10"
,13/04/2022,Expense Transaction (Bank Draft),Mary1479,Musselbrook Machine Maintenance Ltd,,EastX ****2310,-668.16,"706,218.94"
,13/04/2022,Expense Transaction (Bank Draft),Mary1483,IDR Associates,,EastX ****2310,"-9,415.37","696,803.57"
,13/04/2022,Expense Transaction (Bank Draft),Mary1475,Jay Spark Co Ltd,,EastX ****2310,-55.27,"696,748.30"
,13/04/2022,Expense Transaction (Bank Draft),Mary1472,Dirty laundry,,EastX ****2310,-38.4,"696,709.90"
,13/04/2022,Expense Transaction (Bank Draft),Mary1474,GWT Media,,EastX ****2310,-207,"696,502.90"
,13/04/2022,Expense Transaction (Bank Draft),Mary1473,TimberLake Workshop,,EastX ****2310,-590.4,"695,912.50"
,13/04/2022,Expense Transaction (Bank Draft),Mary1477,Laser Welding Services,,EastX ****2310,"-1,475.10","694,437.40"
,13/04/2022,Expense Transaction (Bank Draft),Mary1481,Kerast,,EastX ****2310,"-1,184.40","693,253.00"
,13/04/2022,Expense Transaction (Bank Draft),Mary1478,London Barrel Maker,,EastX ****2310,"-3,000.00","690,253.00"
,13/04/2022,Expense Transaction (Bank Draft),Mary1468,ARC,,EastX ****2310,-80.14,"690,172.86"
,13/04/2022,Expense Transaction (Bank Draft),Mary1467,Aform Tooling Limited,,EastX ****2310,"-1,070.40","689,102.46"
,13/04/2022,Expense Transaction (Bank Draft),Mary1469,Barton Gun Work,,EastX ****2310,-257.76,"688,844.70"
,13/04/2022,Expense,80145462,LAMBETH,,ADMINISTRATION:Office Cleaning,142.62,"688,987.32"
,13/04/2022,Expense,40/2920094,Willis Towers Watson,,PreTransactions,386.2,"689,373.52"
,13/04/2022,Expense,2021019,Ian Clarke,,-Split-,513.66,"689,887.18"
,13/04/2022,Expense,,Jenna Gearing miss,,-Split-,"2,520.00","692,407.18"
,13/04/2022,Expense,2021021,Ian Clarke,,-Split-,56.34,"692,463.52"
,13/04/2022,Expense,2021020,Ian Clarke,,-Split-,245.34,"692,708.86"
,13/04/2022,Expense,2021018,Ian Clarke,,-Split-,407.34,"693,116.20"
,13/04/2022,Expense,,Harper Office,,ADMINISTRATION:Office Supplies,590.4,"693,706.60"
,13/04/2022,Expense,63,Ray St Ledger & Sons,,Work in Progress,"2,214.00","695,920.60"
,13/04/2022,Expense Transaction (Bank Draft),Mary1471,Cooper Roberts,,EastX ****2310,-270,"695,650.60"
,14/04/2022,Expense Transaction (Bank Draft),Mary1485,Star Lapel Pin Co. Ltd,,EastX ****2310,-123.7,"695,526.90"
,14/04/2022,Expense,44305,The Company of Gunmakers,,-Split-,333.33,"695,860.23"
,14/04/2022,Expense Transaction (Bank Draft),9182,Worldpay,,Apple Account,-61.34,"695,798.89"
,15/04/2022,Expense Transaction (Bank Draft),Mary1522,UPS,,EastX ****2310,-408.5,"695,390.39"
,15/04/2022,Expense,699150,Jay Spark Co Ltd,,-Split-,25.34,"695,415.73"
,15/04/2022,Expense,3598,Tweed Media,,-Split-,"4,846.38","700,262.11"
,15/04/2022,Expense Transaction (Bank Draft),Mary1461,Barton Gun Work,,EastX ****2310,-257.76,"700,004.35"
,17/04/2022,Expense,,T & D O'Neill,,-Split-,320,"700,324.35"
,17/04/2022,Expense,NI144879,Big Yellow Self Storage,,-Split-,"1,132.88","701,457.23"
,19/04/2022,Expense Transaction (Bank Draft),Mary1497,Ian Clarke,,EastX ****2310,"-5,679.00","695,778.23"
,19/04/2022,Expense,SLTI300078,Cargo Overseas Limited,,MARKETING/SELLING:Postage and Delivery,75,"695,853.23"
,19/04/2022,Expense Transaction (Bank Draft),Mary1492,Firma Alfred Schilling,,EastX ****2310,-286.09,"695,567.14"
,19/04/2022,Expense Transaction (Bank Draft),Mary1491,Excelmate,,EastX ****2310,-70,"695,497.14"
,19/04/2022,Expense Transaction (Bank Draft),Mary1494,A G Sinnett,,EastX ****2310,-189.88,"695,307.26"
,19/04/2022,Expense Transaction (Bank Draft),Mary1495,Jamie,,EastX ****2310,-365.84,"694,941.42"
,19/04/2022,Expense Transaction (Bank Draft),Mary1493,Jenna Gearing miss,,EastX ****2310,"-2,520.00","692,421.42"
,19/04/2022,Expense,,Willis Towers Watson,paid 23 Apr 21,ADMINISTRATION:Insurance Expense,214.26,"692,635.68"
,19/04/2022,Expense,210403,Mayfair  Engineering,,Work in Progress,84,"692,719.68"
,19/04/2022,Expense,,WORKMAN EDWARD,,-Split-,148.3,"692,867.98"
,19/04/2022,Expense,,A G Sinnett,,-Split-,189.88,"693,057.86"
,19/04/2022,Expense,,Cargo Overseas Limited,,MARKETING/SELLING:Postage and Delivery,288.25,"693,346.11"
,19/04/2022,Expense,,Aerial Direct,,MARKETING/SELLING:Telephone Expense,223.9,"693,570.01"
,19/04/2022,Expense,6662,Field Sports Publishing Inc,,MARKETING/SELLING:Advertising/Promotional,"2,764.64","696,334.65"
,19/04/2022,Expense,2104-041,Dorleac and Dorleac,,Work in Progress,310.35,"696,645.00"
,19/04/2022,Expense,,G Duffey,,Commission,"3,561.99","700,206.99"
,19/04/2022,Expense,,WORKMAN EDWARD,,-Split-,645.4,"700,852.39"
,19/04/2022,Expense,RE0125,Outleap GmbH & Co,,ADMINISTRATION:Computer and Internet Expenses,"1,170.37","702,022.76"
,19/04/2022,Expense Transaction (Bank Draft),Mary1496,G Duffey,,EastX ****2310,"-3,561.99","698,460.77"
,20/04/2022,Expense,276810,Ruag Ammotec (UK) Ltd,,-Split-,645.16,"699,105.93"
,20/04/2022,Expense,,SRS Freight Ltd,,Cost of sales,60,"699,165.93"
,20/04/2022,Expense,600517,Traditional English Guncases Ltd,,Work in Progress,"6,000.00","705,165.93"
,20/04/2022,Expense,1850,L W Butler,,-Split-,"4,113.60","709,279.53"
,20/04/2022,Expense,8400026012,Northwood Group,,Cost of sales,331.63,"709,611.16"
,20/04/2022,Expense,1711,TimberLake Workshop,,-Split-,116.4,"709,727.56"
,21/04/2022,Expense Transaction (Bank Draft),9379,AXA Insurance,,EastX Bank,-77.39,"709,650.17"
,21/04/2022,Expense Transaction (Bank Draft),Mary2188,Willis Towers Watson,,EastX ****2310,-214.26,"709,435.91"
,21/04/2022,Expense Transaction (Bank Draft),Mary1498,Parcelforce,,EastX ****2310,-175.46,"709,260.45"
,21/04/2022,Expense,133,Paua Trading Limited,,-Split-,456,"709,716.45"
,21/04/2022,Expense,,Steve Kelly,,-Split-,"1,500.00","711,216.45"
,21/04/2022,Expense,414864,P Higgins & Sons Ltd,,Work in Progress,"2,400.00","713,616.45"
,21/04/2022,Expense,1702,Helston Gunsmiths,,Cost of sales,33.6,"713,650.05"
,22/04/2022,Expense,7516,Gamefair,,PreTransactions,"2,683.80","716,333.85"
,22/04/2022,Expense,7528,Gamefair,,PreTransactions,"5,016.00","721,349.85"
,25/04/2022,Expense,,Mary Gil,,-Split-,37.49,"721,387.34"
,25/04/2022,Expense,,Ian Clarke,,-Split-,"4,456.32","725,843.66"
,25/04/2022,Expense,5835,Beck Office,,Bookkeeping & Payroll,72,"725,915.66"
,26/04/2022,Expense,20753,TMC Ltd,,PreTransactions,"14,759.40","740,675.06"
,27/04/2022,Expense Transaction (Bank Draft),9186,dr. E. Stief - Jagdwaffen,,Apple Account,"-1,050.00","739,625.06"
,27/04/2022,Expense Transaction (Bank Draft),Mary1499,dr. E. Stief - Jagdwaffen,,EastX ****2310,"-6,952.69","732,672.37"
,27/04/2022,Expense,2.10E+13,Northwood Group UK Vendor,,Cost of sales,"1,630.80","734,303.17"
,27/04/2022,Expense,445,ARC Ballistics Limited,,-Split-,"3,202.20","737,505.37"
,27/04/2022,Expense,2539,Arms Restoration Services,,Work in Progress,900,"738,405.37"
,27/04/2022,Expense,,T & D O'Neill,,-Split-,470,"738,875.37"
,27/04/2022,Expense,1723,TimberLake Workshop,,-Split-,81.6,"738,956.97"
,27/04/2022,Expense,344,IPS Gunmaking Ltd,,Work in Progress,"2,365.00","741,321.97"
,27/04/2022,Expense,67,Ray St Ledger & Sons,,-Split-,"1,080.00","742,401.97"
,27/04/2022,Expense,600521,Traditional English Guncases Ltd,,Cost of sales,474,"742,875.97"
,27/04/2022,Expense,,Northwood Group UK Vendor,,Work in Progress,"8,481.60","751,357.57"
,28/04/2022,Expense Transaction (Bank Draft),Mary1532,Propel Finance No 1,,EastX ****2310,-218.16,"751,139.41"
,28/04/2022,Expense,,Propel Finance No 1,,MARKETING/SELLING:Telephone Expense,218.16,"751,357.57"
,28/04/2022,Expense,26563,Alan Rhone lTD,,-Split-,20.3,"751,377.87"
,28/04/2022,Expense,985,T F Wood & Son,,Stock / Inventory Asset,"2,850.00","754,227.87"
,28/04/2022,Expense,,Mark Remmant,,-Split-,173.2,"754,401.07"
,29/04/2022,Expense Transaction (Bank Draft),Mary1503,Worldpay,,EastX ****2310,"-1,704.78","752,696.29"
,29/04/2022,Expense Transaction (Bank Draft),Mary1500,Mark Remmant,,EastX ****2310,-173.2,"752,523.09"
,29/04/2022,Expense Transaction (Bank Draft),Mary1505,Tweed Media,,EastX ****2310,"-4,846.38","747,676.71"
,29/04/2022,Expense Transaction (Bank Draft),Mary1501,Mary Gil,,EastX ****2310,-37.49,"747,639.22"
,29/04/2022,Expense Transaction (Bank Draft),Mary1533,Mustard ties,,EastX ****2310,-37.2,"747,602.02"
,29/04/2022,Expense,2021-0043,Revolution Wines,,MARKETING/SELLING:Postage and Delivery,24,"747,626.02"
,29/04/2022,Expense Transaction (Bank Draft),Mary1502,Cargo Overseas Limited,,EastX ****2310,-363.25,"747,262.77"
,29/04/2022,Expense Transaction (Bank Draft),Mary1506,TMC Ltd,,EastX ****2310,"-14,759.40","732,503.37"
,29/04/2022,Expense Transaction (Bank Draft),Mary1507,Gamefair,,EastX ****2310,"-7,699.80","724,803.57"
,29/04/2022,Expense,,Steve Helsley,,MARKETING/SELLING:Consultants,511,"725,314.57"
,29/04/2022,Expense,,T & D O'Neill,,-Split-,250,"725,564.57"
,29/04/2022,Expense Transaction (Bank Draft),Mary1504,Paua Trading Limited,,EastX ****2310,-456,"725,108.57"
,30/04/2022,Vendor Credit,,Northwood Group,,ADMINISTRATION:Exchange Rate cost,-191.31,"724,917.26"
,30/04/2022,Expense Transaction (Bank Draft),Mary1535,Steve Helsley,,EastX ****2310,-511,"724,406.26"
,30/04/2022,Expense Transaction (Bank Draft),Mary1536,Aerial Direct,,EastX ****2310,-223.9,"724,182.36"
,30/04/2022,Expense,,Northwood Group,,Shared cost,"1,015.00","725,197.36"
,30/04/2022,Expense,,L & O Immobilien GMBH & Co KG,,ADMINISTRATION:Rent & Rates Expense,"10,666.11","735,863.47"
,30/04/2022,Expense,20-Jan,dr. E. Stief - Jagdwaffen,Expense dated 2 Sep 2020,Stock / Inventory Asset,"8,451.20","744,314.67"
,30/04/2022,Expense,,Northwood Group,,Shared cost,"2,636.50","746,951.17"
,30/04/2022,Expense,150280416,Worldpay,,ADMINISTRATION:Bank & card charges,114.14,"747,065.31"
,30/04/2022,Expense,3091085068,Leica Camera AG,,Cost of sales,"1,910.04","748,975.35"
,30/04/2022,Expense,GD0421,Northwood USA,,MARKETING/SELLING:Consultants,"4,555.80","753,531.15"
,1/5/2022,Expense Transaction (Bank Draft),Mary1586,Eurl Remi Richard,,-Split-,,"753,531.15"
,1/5/2022,Expense,2.10E+13,Northwood Group UK Vendor,,Stock / Inventory Asset,"3,796.80","757,327.95"
,1/5/2022,Expense,2,Frederique Lepinois,,Work in Progress,"12,700.00","770,027.95"
,1/5/2022,Expense,2.10E+13,Northwood Group UK Vendor,,Stock / Inventory Asset,21.6,"770,049.55"
,1/5/2022,Expense,49882841,UPS,,MARKETING/SELLING:Postage and Delivery,16.49,"770,066.04"
,1/5/2022,Expense,34130,Derse Inc,,MARKETING/SELLING:Marketing,428.72,"770,494.76"
,1/5/2022,Expense,44188,The Company of Gunmakers,,-Split-,156.62,"770,651.38"
,1/5/2022,Expense,1144,Cooper Roberts,,Storage,270,"770,921.38"
,1/5/2022,Expense,17426,GWT Media,,ADMINISTRATION:Computer and Internet Expenses,207,"771,128.38"
,1/5/2022,Expense,1128,Cooper Roberts,,Storage,270,"771,398.38"
,1/5/2022,Expense,,SNT Adventure Brands LLC,,Stock / Inventory Asset,"1,745.00","773,143.38"
,1/5/2022,Vendor Credit,,Eurl Remi Richard,,Stock / Inventory Asset,-400,"772,743.38"
,1/5/2022,Expense,14792,Northwood Group UK Vendor,,Cost of sales,478.8,"773,222.18"
,1/5/2022,Expense,600528,Traditional English Guncases Ltd,,Work in Progress,"6,000.00","779,222.18"
,1/5/2022,Expense,015/2022,L & O Immobilien GMBH & Co KG,,ADMINISTRATION:Rent & Rates Expense,"10,666.11","789,888.29"
,1/5/2022,Expense,,Eurl Remi Richard,,Stock / Inventory Asset,369.42,"790,257.71"
,1/5/2022,Expense,,Kerast,,Cost of sales,174.6,"790,432.31"
,1/5/2022,Expense,1015,Albion Sporting LTD,,-Split-,"1,813.50","792,245.81"
,1/5/2022,Expense,LV904778,Derse Inc,£1 = $1.40,MARKETING/SELLING:Marketing,428.72,"792,674.53"
,1/5/2022,Expense,75386,Kerast,,-Split-,233.4,"792,907.93"
,1/5/2022,Expense,931,SonySports Press Limited,,MARKETING/SELLING:Advertising/Promotional,"1,794.00","794,701.93"
,1/5/2022,Expense,,WORKMAN EDWARD,,-Split-,418.22,"795,120.15"
,1/5/2022,Expense Transaction (Bank Draft),796,BrandCo Branding Ltd,,Business Card,-318.19,"794,801.96"
,4/5/2022,Expense Transaction (Bank Draft),Mary1570,Big Yellow Self Storage,,EastX ****2310,"-1,132.88","793,669.08"
,4/5/2022,Expense Transaction (Bank Draft),Mary1571,UPS,,EastX ****2310,-58.02,"793,611.06"
,4/5/2022,Expense,15,Royal,,PreTransactions,"96,000.00","889,611.06"
,4/5/2022,Expense Transaction (Bank Draft),9187,Northwood USA,,Apple Account,"-20,929.00","868,682.06"
,4/5/2022,Expense Transaction (Bank Draft),Mary1569,guntrader.co.uk,,EastX ****2310,-17.4,"868,664.66"
,4/5/2022,Expense Transaction (Bank Draft),9303,L & O Immobilien GMBH & Co KG,,EastX Bank,"-10,666.11","857,998.55"
,5/5/2022,Expense Transaction (Bank Draft),Mary1509,Beck Office,,EastX ****2310,-72,"857,926.55"
,5/5/2022,Expense,2021032,Ian Clarke,,-Split-,"6,000.00","863,926.55"
,5/5/2022,Expense Transaction (Bank Draft),Mary1515,Ray St Ledger & Sons,,EastX ****2310,"-3,688.80","860,237.75"
,5/5/2022,Expense Transaction (Bank Draft),Mary1521,WORKMAN EDWARD,,EastX ****2310,-793.7,"859,444.05"
,5/5/2022,Expense Transaction (Bank Draft),Mary1562,Marc Newton Expenses,,EastX ****2310,-40,"859,404.05"
,5/5/2022,Expense Transaction (Bank Draft),Mary1518,T & D O'Neill,,EastX ****2310,"-1,890.00","857,514.05"
,5/5/2022,Expense Transaction (Bank Draft),Mary1516,Ruag Ammotec (UK) Ltd,,EastX ****2310,-645.16,"856,868.89"
,5/5/2022,Expense Transaction (Bank Draft),Mary1511,Helston Gunsmiths,,EastX ****2310,-33.6,"856,835.29"
,5/5/2022,Expense Transaction (Bank Draft),Mary1508,Alan Rhone lTD,,EastX ****2310,-20.3,"856,814.99"
,5/5/2022,Expense Transaction (Bank Draft),Mary1513,Jay Spark Co Ltd,,EastX ****2310,-47.2,"856,767.79"
,5/5/2022,Expense Transaction (Bank Draft),Mary1510,TimberLake Workshop,,EastX ****2310,-116.4,"856,651.39"
,5/5/2022,Expense Transaction (Bank Draft),Mary1520,The Company of Gunmakers,,EastX ****2310,-333.33,"856,318.06"
,5/5/2022,Expense Transaction (Bank Draft),Mary1519,T F Wood & Son,,EastX ****2310,"-2,850.00","853,468.06"
,5/5/2022,Expense Transaction (Bank Draft),Mary1512,IPS Gunmaking Ltd,,EastX ****2310,"-6,131.00","847,337.06"
,5/5/2022,Expense Transaction (Bank Draft),Mary1517,Steve Kelly,,EastX ****2310,"-1,500.00","845,837.06"
,5/5/2022,Expense,2021031,Ian Clarke,,Work in Progress,282,"846,119.06"
,5/5/2022,Expense,240844,CTS (GB) Limited,,MARKETING/SELLING:Import Duty,871.75,"846,990.81"
,5/5/2022,Expense,1010098998,Sage UK Limited,,ADMINISTRATION:Office - Computer expenses,410.4,"847,401.21"
,5/5/2022,Expense,2857,DMC Custom Cartridges,,-Split-,750,"848,151.21"
,5/5/2022,Expense,2.11E+13,Northwood Group UK Vendor,,Stock / Inventory Asset,903.6,"849,054.81"
,5/5/2022,Expense,19058,Clarity,,Bookkeeping & Payroll,240,"849,294.81"
,5/5/2022,Expense,66901,ARC,,ADMINISTRATION:Office Supplies,81.67,"849,376.48"
,5/5/2022,Expense Transaction (Bank Draft),Mary1514,Nigel Westway,,EastX ****2310,"-5,500.00","843,876.48"
,6/5/2022,Expense,INV-17511,GWT Media,,ADMINISTRATION:Computer and Internet Expenses,90,"843,966.48"
,6/5/2022,Expense,12107,Bronze Age Art Foundry Limited,,-Split-,930,"844,896.48"
,6/5/2022,Expense,21455585,Rentokil,,MARKETING/SELLING:Repair and maintenance,352.78,"845,249.26"
,6/5/2022,Expense,,Marc Newton Expenses,,MARKETING/SELLING:Subsistasnce and Entertainment expenses,40,"845,289.26"
,6/5/2022,Expense,21,Brock & Norris,,-Split-,488.62,"845,777.88"
,7/5/2022,Expense Transaction (Bank Draft),Mary1537,Ian Clarke,,EastX ****2310,"-6,282.00","839,495.88"
,7/5/2022,Expense Transaction (Bank Draft),Mary1573,Alexander J Nielsen,,EastX ****2310,-400,"839,095.88"
,7/5/2022,Expense,210503,Mayfair  Engineering,,-Split-,"6,780.00","845,875.88"
,7/5/2022,Expense Transaction (Bank Draft),Mary1540,P Higgins & Sons Ltd,,EastX ****2310,"-2,400.00","843,475.88"
,7/5/2022,Expense,,Alexander J Nielsen,,MARKETING/SELLING,400,"843,875.88"
,7/5/2022,Expense Transaction (Bank Draft),Mary1538,Ian Moran,,EastX ****2310,"-3,500.00","840,375.88"
,8/5/2022,Expense Transaction (Bank Draft),Mary1544,Revolution Wines,,EastX ****2310,-24,"840,351.88"
,8/5/2022,Expense Transaction (Bank Draft),Mary1551,Arms Restoration Services,,EastX ****2310,-900,"839,451.88"
,8/5/2022,Expense Transaction (Bank Draft),Mary1554,Helston Gunsmiths,,EastX ****2310,-731.4,"838,720.48"
,8/5/2022,Expense Transaction (Bank Draft),Mary1548,L W Butler,,EastX ****2310,"-4,113.60","834,606.88"
,8/5/2022,Expense Transaction (Bank Draft),Mary1555,GWT Media,,EastX ****2310,-207,"834,399.88"
,8/5/2022,Expense Transaction (Bank Draft),Mary1553,IPS Gunmaking Ltd,,EastX ****2310,"-2,365.00","832,034.88"
,8/5/2022,Expense Transaction (Bank Draft),Mary1560,Cooper Roberts,,EastX ****2310,-270,"831,764.88"
,8/5/2022,Expense Transaction (Bank Draft),Mary1556,TimberLake Workshop,,EastX ****2310,-81.6,"831,683.28"
,8/5/2022,Expense Transaction (Bank Draft),Mary1542,Traditional English Guncases Ltd,,EastX ****2310,"-24,762.00","806,921.28"
,8/5/2022,Expense Transaction (Bank Draft),Mary1558,Harper Office,,EastX ****2310,"-1,739.66","805,181.62"
,8/5/2022,Expense Transaction (Bank Draft),Mary1550,ARC,,EastX ****2310,-81.67,"805,099.95"
,8/5/2022,Expense Transaction (Bank Draft),Mary1552,ARC Ballistics Limited,,EastX ****2310,"-3,202.20","801,897.75"
,8/5/2022,Expense Transaction (Bank Draft),Mary1543,T & D O'Neill,,EastX ****2310,-720,"801,177.75"
,8/5/2022,Expense Transaction (Bank Draft),Mary1557,Clarity,,EastX ****2310,-240,"800,937.75"
,8/5/2022,Expense Transaction (Bank Draft),Mary1545,Mayfair  Engineering,,EastX ****2310,"-7,248.00","793,689.75"
,8/5/2022,Expense Transaction (Bank Draft),Mary1546,Leica Camera AG,,EastX ****2310,"-1,910.04","791,779.71"
,8/5/2022,Expense Transaction (Bank Draft),Mary1547,LAMBETH,,EastX ****2310,-142.62,"791,637.09"
,8/5/2022,Expense Transaction (Bank Draft),Mary1559,CTS (GB) Limited,,EastX ****2310,-871.75,"790,765.34"
,8/5/2022,Expense Transaction (Bank Draft),Mary1549,Jay Spark Co Ltd,,EastX ****2310,-117.76,"790,647.58"
,9/5/2022,Expense,2861,DMC Custom Cartridges,,Cost of sales,300,"790,947.58"
,10/5/2022,Expense Transaction (Bank Draft),Mary1576,Outleap GmbH & Co,,EastX ****2310,"-1,170.37","789,777.21"
,10/5/2022,Expense Transaction (Bank Draft),Mary1575,Jerome  Lannoue,,EastX ****2310,"-1,081.50","788,695.71"
,10/5/2022,Expense Transaction (Bank Draft),Mary1574,Jerome  Lannoue,,EastX ****2310,-379.81,"788,315.90"
,10/5/2022,Expense,Sales Order,Wbc,,Cost of sales,360,"788,675.90"
,11/5/2022,Expense Transaction (Bank Draft),Mary1578,Wbc,,EastX ****2310,-360,"788,315.90"
,11/5/2022,Expense,INV277109,Ruag Ammotec (UK) Ltd,,-Split-,256.53,"788,572.43"
,11/5/2022,Expense,8400030367,Northwood Group,,MARKETING/SELLING:Postage and Delivery,332,"788,904.43"
,12/5/2022,Expense,44358,The Company of Gunmakers,,Cost of sales,15.9,"788,920.33"
,12/5/2022,Expense,Ancient15,Dirty laundry,,ADMINISTRATION:Cleaning Supplies,38.4,"788,958.73"
,12/5/2022,Expense,PROforma / 113593,BrandCo Branding Ltd,,-Split-,343.92,"789,302.65"
,13/05/2022,Expense,80146409,LAMBETH,,ADMINISTRATION:Office Cleaning,160.25,"789,462.90"
,13/05/2022,Expense Transaction (Bank Draft),Mary1561,The Butcher & Larder,,EastX ****2310,-176.2,"789,286.70"
,14/05/2022,Expense,INV102748,SRS Freight Ltd,,-Split-,642.62,"789,929.32"
,14/05/2022,Expense,INV102749,SRS Freight Ltd,,-Split-,645.2,"790,574.52"
,15/05/2022,Expense,,The White Horse,,PreTransactions,"1,372.75","791,947.27"
,15/05/2022,Expense,20210270,Armurerie Paul Pletsers,1£=1.15943 EUR,Stock / Inventory Asset,"3,119.93","795,067.20"
,15/05/2022,Expense,1004,SonySports Press Limited,,MARKETING/SELLING:Marketing,"1,794.00","796,861.20"
,15/05/2022,Expense,40646,guntrader.co.uk,,ADMINISTRATION:Subscription,17.4,"796,878.60"
,15/05/2022,Expense,3611,Tweed Media,,-Split-,"4,964.24","801,842.84"
,16/05/2022,Expense,,Jamie,,MARKETING/SELLING:Petrol,422.82,"802,265.66"
,17/05/2022,Expense,44364,The Company of Gunmakers,,-Split-,107.1,"802,372.76"
,17/05/2022,Expense,1351,Broadbent Leather goods,,-Split-,202.5,"802,575.26"
,17/05/2022,Expense,18,Royal,,Work in Progress,"57,000.00","859,575.26"
,18/05/2022,Expense,INV277283,Ruag Ammotec (UK) Ltd,,Stock / Inventory Asset,"1,702.45","861,277.71"
,18/05/2022,Expense,NI145858,Big Yellow Self Storage,,-Split-,"1,132.88","862,410.59"
,18/05/2022,Expense,H19DA1DBB9,eon,,ADMINISTRATION:Utilities,96.48,"862,507.07"
,18/05/2022,Expense,1294,John Whitfield,,-Split-,840,"863,347.07"
,19/05/2022,Expense Transaction (Bank Draft),Mary1584,Parcelforce,,EastX ****2310,-285.78,"863,061.29"
,19/05/2022,Expense Transaction (Bank Draft),Mary1564,Armurerie Paul Pletsers,,EastX ****2310,"-3,119.93","859,941.36"
,19/05/2022,Expense Transaction (Bank Draft),Mary1563,Jamie,,EastX ****2310,-422.82,"859,518.54"
,19/05/2022,Expense Transaction (Bank Draft),Mary1566,DMC Custom Cartridges,,EastX ****2310,-750,"858,768.54"
,19/05/2022,Expense,,A G Sinnett,,-Split-,149.04,"858,917.58"
,19/05/2022,Expense Transaction (Bank Draft),Mary1567,DMC Custom Cartridges,,EastX ****2310,-300,"858,617.58"
,19/05/2022,Expense Transaction (Bank Draft),9301,Royal,,EastX Bank,"-57,000.00","801,617.58"
,19/05/2022,Expense Transaction (Bank Draft),Mary1591,A G Sinnett,,EastX ****2310,-149.04,"801,468.54"
,19/05/2022,Expense,457,London Barrel Maker,,Work in Progress,"3,000.00","804,468.54"
,19/05/2022,Expense Transaction (Bank Draft),Mary1565,Ruag Ammotec (UK) Ltd,,EastX ****2310,-256.53,"804,212.01"
,20/05/2022,Expense,22732,Hambrusch,Total Receipt 2140 Euro,-Split-,"1,850.08","806,062.09"
,20/05/2022,Expense,,Northwood Group,,MARKETING/SELLING:Postage and Delivery,"2,144.06","808,206.15"
,21/05/2022,Expense,,WORKMAN EDWARD,,-Split-,850,"809,056.15"
,21/05/2022,Expense,6360,CA Bookkeeping Services Ltd,,Bookkeeping & Payroll,"2,534.40","811,590.55"
,21/05/2022,Expense,210504,Mayfair  Engineering,,-Split-,"7,080.00","818,670.55"
,21/05/2022,Expense,345,IPS Gunmaking Ltd,,Work in Progress,"1,504.00","820,174.55"
,24/05/2022,Expense,,MAnoMAno,Waiting For the Receipt,MARKETING/SELLING,47.99,"820,222.54"
,24/05/2022,Expense Transaction (Bank Draft),Mary1568,ASIC S A of Switzerland,,EastX ****2310,"-2,897.20","817,325.34"
,24/05/2022,Expense,31,Steve Kelly,,-Split-,"2,475.00","819,800.34"
,24/05/2022,Expense,,William Wild,,Work in Progress,"2,500.00","822,300.34"
,25/05/2022,Expense,,JP Smithson Ltd,$875 ,-Split-,618.25,"822,918.59"
,25/05/2022,Expense,21,Royal,,Work in Progress,"3,282.00","826,200.59"
,25/05/2022,Expense,INV660153,Wbc,,MARKETING/SELLING,360,"826,560.59"
,25/05/2022,Expense Transaction (Bank Draft),Mary1539,Ray St Ledger & Sons,,EastX ****2310,"-1,080.00","825,480.59"
,25/05/2022,Expense,,Andy Thornton Ltd,,MARKETING/SELLING,318,"825,798.59"
,25/05/2022,Expense,INC296191,Wbc,,Stock / Inventory Asset,128.7,"825,927.29"
,25/05/2022,Expense,n°1001700049,Maisons Du Monde,Waiting For the Receipt,MARKETING/SELLING,153,"826,080.29"
,25/05/2022,Expense,5880,Beck Office,,Bookkeeping & Payroll,72,"826,152.29"
,26/05/2022,Expense,3378,ElS And Co (Pty) Ltd,,PreTransactions,"3,094.00","829,246.29"
,26/05/2022,Expense Transaction (Bank Draft),Mary1596,Eurl Remi Richard,,EastX ****2310,-369.42,"828,876.87"
,26/05/2022,Expense,44/2022,Hi-Life23 srl,317.50 Euro,-Split-,294.47,"829,171.34"
,26/05/2022,Expense,INC296301,Wbc,,Stock / Inventory Asset,16.98,"829,188.32"
,27/05/2022,Expense,16974wor,Aform Tooling Limited,,-Split-,"10,944.00","840,132.32"
,28/05/2022,Expense,210505,Mayfair  Engineering,,-Split-,"6,782.40","846,914.72"
,28/05/2022,Expense Transaction (Bank Draft),Mary1586,Tweed Media,,EastX ****2310,"-4,964.24","841,950.48"
,28/05/2022,Expense,31,BF&D LIMITED,,Work in Progress,"3,700.00","845,650.48"
,28/05/2022,Expense Transaction (Bank Draft),Mary1600,Hi-Life23 srl,,EastX ****2310,-294.47,"845,356.01"
,28/05/2022,Expense Transaction (Bank Draft),Mary1599,Lothar Walther,,EastX ****2310,-186.82,"845,169.19"
,31/05/2022,Vendor Credit,,Ruag Ammotec (UK) Ltd,,Stock / Inventory Asset,-109.61,"845,059.58"
,31/05/2022,Expense Transaction (Bank Draft),898,Cooksongold,,Business Card,-394.42,"844,665.16"
,31/05/2022,Expense Transaction (Bank Draft),897,Cooksongold,,Business Card,"-2,261.83","842,403.33"
,31/05/2022,Expense Transaction (Bank Draft),9189,Northwood USA,,Apple Account,"-10,694.37","831,708.96"
,31/05/2022,Expense,GD0521,Northwood USA,£1 = $1.2201,MARKETING/SELLING:Consultants,"6,138.57","837,847.53"
,31/05/2022,Expense,,Northwood Group,,Shared cost,"1,015.00","838,862.53"
,31/05/2022,Expense,,Gordy& Son,,Commission,"24,000.00","862,862.53"
,31/05/2022,Expense,2021/0994,Rodl & Partner,,-Split-,133,"862,995.53"
,31/05/2022,Expense,600550,Traditional English Guncases Ltd,,Cost of sales,"8,400.00","871,395.53"
,31/05/2022,Expense,,Northwood Group,,Shared cost,"2,636.50","874,032.03"
,31/05/2022,Expense,600551,Traditional English Guncases Ltd,,Work in Progress,"5,724.00","879,756.03"
,1/6/2022,Expense Transaction (Bank Draft),Mary1613,Dorleac and Dorleac,,EastX ****2310,-333.45,"879,422.58"
,1/6/2022,Expense,758,Buck's Club Limited,,-Split-,241.25,"879,663.83"
,1/6/2022,Expense Transaction (Bank Draft),Mary1603,Northwood Group,,-Split-,,"879,663.83"
,1/6/2022,Expense Transaction (Bank Draft),101,SonySports Press Limited,,-Split-,,"879,663.83"
,1/6/2022,Expense Transaction (Bank Draft),Mary1629,DHL,,EastX ****2310,-380.26,"879,283.57"
,1/6/2022,Expense,OP/I768205,GMK,,-Split-,391.09,"879,674.66"
,1/6/2022,Expense,154616759,Worldpay,,-Split-,84.67,"879,759.33"
,1/6/2022,Expense,,The Company of Gunmakers,,Cost of sales,395.71,"880,155.04"
,1/6/2022,Expense,44389,The Company of Gunmakers,,Cost of sales,132.4,"880,287.44"
,1/6/2022,Expense,44372,The Company of Gunmakers,,Cost of sales,60,"880,347.44"
,1/6/2022,Expense,458,London Barrel Maker,,Work in Progress,"3,000.00","883,347.44"
,1/6/2022,Expense,72,Ray St Ledger & Sons,,Accruals,"1,654.80","885,002.24"
,1/6/2022,Expense,1154,Cooper Roberts,,Storage,270,"885,272.24"
,1/6/2022,Expense,AVI8456656,DHL,,MARKETING/SELLING:Postage and Delivery,330.54,"885,602.78"
,1/6/2022,Expense,AVI8378117,DHL,,MARKETING/SELLING:Postage and Delivery,"1,149.74","886,752.52"
,1/6/2022,Expense,8400034590,Northwood Group,,Stock / Inventory Asset,642,"887,394.52"
,1/6/2022,Expense,17511,GWT Media,,ADMINISTRATION:Computer and Internet Expenses,90,"887,484.52"
,1/6/2022,Expense,,Redhead International,,MARKETING/SELLING:Postage and Delivery,50,"887,534.52"
,1/6/2022,Expense,,L & O Immobilien GMBH & Co KG,,ADMINISTRATION:Rent & Rates Expense,"10,666.12","898,200.64"
,1/6/2022,Expense,AVI8286739,DHL,,MARKETING/SELLING:Postage and Delivery,85.01,"898,285.65"
,1/6/2022,Expense,16794,GWT Media,,ADMINISTRATION:Computer and Internet Expenses,45,"898,330.65"
,1/6/2022,Expense,1351,Broadbent Leather goods,,-Split-,202.5,"898,533.15"
,1/6/2022,Expense,1332,Broadbent Leather goods,,-Split-,480,"899,013.15"
,1/6/2022,Expense,AVI8397882,DHL,,MARKETING/SELLING:Postage and Delivery,265.54,"899,278.69"
,1/6/2022,Expense,1296,John Whitfield,,-Split-,220,"899,498.69"
,1/6/2022,Expense,AVI7971069,DHL,,MARKETING/SELLING:Postage and Delivery,816.38,"900,315.07"
,1/6/2022,Expense,,Northwood Group,,Stock / Inventory Asset,674,"900,989.07"
,1/6/2022,Expense,74,Ray St Ledger & Sons,,Work in Progress,367.2,"901,356.27"
,1/6/2022,Expense,26582,Alan Rhone lTD,,Stock / Inventory Asset,819.2,"902,175.47"
,1/6/2022,Expense,INV-6421,CA Bookkeeping Services Ltd,,Bookkeeping & Payroll,844.8,"903,020.27"
,1/6/2022,Expense,156,Fox & Co Bespokw Ltd,,-Split-,"1,326.00","904,346.27"
,1/6/2022,Expense,75,Ray St Ledger & Sons,,Stock / Inventory Asset,972,"905,318.27"
,1/6/2022,Expense,1191JRL,Laser Welding Services,,-Split-,158.22,"905,476.49"
,1/6/2022,Expense,8400034581,Northwood Group,,Shipping & Freight,674,"906,150.49"
,1/6/2022,Expense,76,Ray St Ledger & Sons,,Stock / Inventory Asset,194.4,"906,344.89"
,1/6/2022,Expense,61630,Manchester Automatic Machining,,-Split-,386.4,"906,731.29"
,1/6/2022,Expense,1112,Cooper Roberts,,Storage,270,"907,001.29"
,1/6/2022,Expense,73,Ray St Ledger & Sons,,Work in Progress,"1,437.60","908,438.89"
,1/6/2022,Expense,17587,GWT Media,,ADMINISTRATION:Computer and Internet Expenses,203.4,"908,642.29"
,1/6/2022,Vendor Credit,,Northwood Group,,Shipping & Freight,-674,"907,968.29"
,1/6/2022,Vendor Credit,CN931,SonySports Press Limited,,MARKETING/SELLING:Advertising/Promotional,"-1,794.00","906,174.29"
,1/6/2022,Vendor Credit,,DHL,,MARKETING/SELLING:Postage and Delivery,-436.12,"905,738.17"
,1/6/2022,Expense,59000,Aerial Direct,dated 21/05/2022,MARKETING/SELLING:Telephone Expense,560.4,"906,298.57"
,1/6/2022,Expense,2869,DMC Custom Cartridges,,Stock / Inventory Asset,258,"906,556.57"
,1/6/2022,Expense,PD37,Natraj Publishers,,-Split-,272.5,"906,829.07"
,1/6/2022,Expense,299,Phil Coggan,,Work in Progress,"57,000.00","963,829.07"
,1/6/2022,Expense Transaction (Bank Draft),Mary1631,DHL,,-Split-,,"963,829.07"
,2/6/2022,Expense Transaction (Bank Draft),Mary1541,Big Yellow Self Storage,,EastX ****2310,"-1,132.88","962,696.19"
,2/6/2022,Expense Transaction (Bank Draft),Mary1619,Ian Clarke,,EastX ****2310,"-3,780.00","958,916.19"
,2/6/2022,Expense Transaction (Bank Draft),Mary1617,Worldpay,,EastX ****2310,-84.67,"958,831.52"
,2/6/2022,Expense Transaction (Bank Draft),Mary1593,Bronze Age Art Foundry Limited,,EastX ****2310,-930,"957,901.52"
,2/6/2022,Expense Transaction (Bank Draft),Mary1620,Classic Shooting Switzerland,,EastX ****2310,"-12,214.48","945,687.04"
,2/6/2022,Expense Transaction (Bank Draft),Mary1618,GWT Media,,EastX ****2310,-338.4,"945,348.64"
,3/6/2022,Expense Transaction (Bank Draft),Mary1604,Sage UK Limited,,EastX ****2310,-410.4,"944,938.24"
,3/6/2022,Expense Transaction (Bank Draft),9307,Royal,,EastX Bank,"-48,000.00","896,938.24"
,3/6/2022,Expense Transaction (Bank Draft),Mary1603,CA Bookkeeping Services Ltd,,EastX ****2310,"-2,534.40","894,403.84"
,3/6/2022,Expense,67572,ARC,,ADMINISTRATION:Office Supplies,38.92,"894,442.76"
,3/6/2022,Expense,1742,A T Miles,,-Split-,"1,206.60","895,649.36"
,3/6/2022,Expense,44417,The Company of Gunmakers,,Work in Progress,48,"895,697.36"
,3/6/2022,Expense,1771,TimberLake Workshop,,-Split-,139.2,"895,836.56"
,4/6/2022,Expense Transaction (Bank Draft),Mary1587,Worldpay,,EastX ****2310,-114.14,"895,722.42"
,4/6/2022,Expense,44419,The Company of Gunmakers,,-Split-,78,"895,800.42"
,4/6/2022,Expense,8400039001,Northwood Group,,Stock in Trnasit,"10,836.00","906,636.42"
,6/6/2022,Expense Transaction (Bank Draft),9310,eon,,EastX Bank,-96.48,"906,539.94"
,6/6/2022,Expense,,Jerome  Lannoue,,-Split-,"1,595.45","908,135.39"
,6/6/2022,Expense Transaction (Bank Draft),9309,L & O Immobilien GMBH & Co KG,,EastX Bank,"-10,666.11","897,469.28"
,6/6/2022,Expense Transaction (Bank Draft),Mary1607,London Barrel Maker,,EastX ****2310,"-3,000.00","894,469.28"
,7/6/2022,Expense Transaction (Bank Draft),Mary1608,Albion Sporting LTD,,EastX ****2310,"-1,813.50","892,655.78"
,7/6/2022,Expense,,Ian Clarke,,-Split-,"3,780.00","896,435.78"
,7/6/2022,Expense,PRO FORMA 201-905-636,Classic Shooting Switzerland,,Cost of sales,"12,214.48","908,650.26"
,8/6/2022,Expense,INV0003377,ElS And Co (Pty) Ltd,,Stock / Inventory Asset,34,"908,684.26"
,8/6/2022,Expense,INV0003375,ElS And Co (Pty) Ltd,,-Split-,"1,015.00","909,699.26"
,8/6/2022,Expense,INV0003374,ElS And Co (Pty) Ltd,,-Split-,"1,080.00","910,779.26"
,8/6/2022,Expense,RIG/3259,The Gun Trade Association,,MARKETING/SELLING:Staff welfare and Training,360,"911,139.26"
,8/6/2022,Expense,INV0003376,ElS And Co (Pty) Ltd,,-Split-,"1,120.00","912,259.26"
,9/6/2022,Expense Transaction (Bank Draft),Mary1610,The Company of Gunmakers,,EastX ****2310,-879.73,"911,379.53"
,9/6/2022,Expense Transaction (Bank Draft),Mary1609,WORKMAN EDWARD,,EastX ****2310,"-1,268.22","910,111.31"
,9/6/2022,Expense Transaction (Bank Draft),Mary1612,William Wild,,EastX ****2310,"-2,500.00","907,611.31"
,9/6/2022,Expense,171,Fox & Co Bespokw Ltd,,-Split-,308.4,"907,919.71"
,9/6/2022,Expense,17690,GWT Media,,ADMINISTRATION:Computer and Internet Expenses,45,"907,964.71"
,9/6/2022,Expense,,Dorleac and Dorleac,,ADMINISTRATION:Exchange Rate cost,23.1,"907,987.81"
,9/6/2022,Expense Transaction (Bank Draft),Mary1611,Steve Kelly,,EastX ****2310,"-2,475.00","905,512.81"
,10/6/2022,Expense,,Jamie,,MARKETING/SELLING:Petrol,277.79,"905,790.60"
,10/6/2022,Expense,AN1365904,Redhead International,,MARKETING/SELLING:Postage and Delivery,50,"905,840.60"
,11/6/2022,Expense Transaction (Bank Draft),Mary1623,Armurerie Paul Pletsers,,EastX ****2310,-61.24,"905,779.36"
,11/6/2022,Expense Transaction (Bank Draft),Mary1625,Redhead International,,EastX ****2310,-50,"905,729.36"
,11/6/2022,Expense,,Hibo Industies (China) Co.Ltd,"Cash Deposit paid 17/06/2022 for $2455  £1,737.98",-Split-,"3,473.82","909,203.18"
,11/6/2022,Expense,,A G Sinnett,,-Split-,259.87,"909,463.05"
,11/6/2022,Expense,8595679,M Mitchell (Gun Makers) Ltd,,-Split-,"14,040.00","923,503.05"
,11/6/2022,Expense,52530,Knighthood International Security Ltd,,MARKETING/SELLING:Repair and maintenance,150,"923,653.05"
,11/6/2022,Expense,20210350,Armurerie Paul Pletsers,,Stock / Inventory Asset,61.24,"923,714.29"
,11/6/2022,Expense,40/2928654,Willis Towers Watson,,ADMINISTRATION:Insurance Expense,98.09,"923,812.38"
,11/6/2022,Expense,32,Steve Kelly,,-Split-,"4,050.00","927,862.38"
,14/06/2022,Expense Transaction (Bank Draft),Mary1647,Derse Inc,,EastX ****2310,-887.6,"926,974.78"
,14/06/2022,Expense Transaction (Bank Draft),Mary1626,BrandCo Branding Ltd,,-Split-,,"926,974.78"
,14/06/2022,Expense Transaction (Bank Draft),Mary1628,Willis Towers Watson,,EastX ****2310,-98.09,"926,876.69"
,14/06/2022,Expense Transaction (Bank Draft),Mary1627,Willis Towers Watson,,EastX ****2310,-409.8,"926,466.89"
,14/06/2022,Vendor Credit,,BrandCo Branding Ltd,,Materials & Tools,-318.19,"926,148.70"
,14/06/2022,Expense,PROFORMA Receipt,Negrini,1 EUR = £0.8581,-Split-,380.08,"926,528.78"
,14/06/2022,Expense,600562,Traditional English Guncases Ltd,Mr Anderson,Cost of sales,"1,440.00","927,968.78"
,14/06/2022,Expense,,BrandCo Branding Ltd,,Work in Progress,318.19,"928,286.97"
,14/06/2022,Expense,9063127916,Parcelforce,,MARKETING/SELLING:Postage and Delivery,10.98,"928,297.95"
,14/06/2022,Expense,44436,The Company of Gunmakers,,Cost of sales,59.4,"928,357.35"
,14/06/2022,Expense,600560,Traditional English Guncases Ltd,Sheikh Al-Sharqi as the case for 7083,Cost of sales,"3,300.00","931,657.35"
,14/06/2022,Expense,600559,Traditional English Guncases Ltd,Davis Peterson,Cost of sales,"2,160.00","933,817.35"
,14/06/2022,Expense,44435,The Company of Gunmakers,,Cost of sales,48,"933,865.35"
,15/06/2022,Expense Transaction (Bank Draft),Mary1649,IPS Gunmaking Ltd,,EastX ****2310,"-3,700.00","930,165.35"
,15/06/2022,Expense Transaction (Bank Draft),Mary1642,BF&D LIMITED,,EastX ****2310,"-3,700.00","926,465.35"
,15/06/2022,Expense Transaction (Bank Draft),Mary1650,Fox & Co Bespokw Ltd,,EastX ****2310,"-1,634.40","924,830.95"
,15/06/2022,Expense Transaction (Bank Draft),Mary1652,Jerome  Lannoue,,EastX ****2310,"-1,595.45","923,235.50"
,15/06/2022,Expense,3633,Tweed Media,,-Split-,"4,920.00","928,155.50"
,15/06/2022,Expense Transaction (Bank Draft),Mary1633,Mayfair  Engineering,,EastX ****2310,"-6,782.40","921,373.10"
,15/06/2022,Vendor Credit,CN-14940,Northwood Group UK Vendor,,Cost of sales,-590.4,"920,782.70"
,15/06/2022,Expense,6685,Field Sports Publishing Inc,,MARKETING/SELLING:Advertising/Promotional,"2,696.70","923,479.40"
,15/06/2022,Expense Transaction (Bank Draft),9312,ElS And Co (Pty) Ltd,,EastX Bank,"-3,249.00","920,230.40"
,16/06/2022,Expense Transaction (Bank Draft),Mary1653,Parcelforce,,EastX ****2310,-553.28,"919,677.12"
,16/06/2022,Expense,,Willis Towers Watson,,ADMINISTRATION:Exchange Rate cost,23.6,"919,700.72"
,16/06/2022,Expense,44445,The Company of Gunmakers,,Work in Progress,92.56,"919,793.28"
,16/06/2022,Expense Transaction (Bank Draft),Mary1626,Swarovski Optik,,EastX ****2310,"-1,666.50","918,126.78"
,17/06/2022,Expense Transaction (Bank Draft),9313,ElS And Co (Pty) Ltd,,EastX Bank,"-3,094.00","915,032.78"
,17/06/2022,Expense Transaction (Bank Draft),9314,Hibo Industies (China) Co.Ltd,,EastX Bank,"-1,782.60","913,250.18"
,17/06/2022,Expense,H19FB674A,eon,,ADMINISTRATION:Utilities,255.5,"913,505.68"
,17/06/2022,Expense,NI146841,Big Yellow Self Storage,,-Split-,"1,132.88","914,638.56"
,17/06/2022,Expense,8400037864,Northwood Group,,Stock in Trnasit,"23,909.16","938,547.72"
,17/06/2022,Expense,8400037863,Northwood Group,,Stock in Trnasit,"68,206.05","1,006,753.77"
,17/06/2022,Expense,2021039,Ian Clarke,,-Split-,"2,348.40","1,009,102.17"
,17/06/2022,Expense,H19F7B9312,eon,,ADMINISTRATION:Utilities,3.49,"1,009,105.66"
,17/06/2022,Expense,414873,P Higgins & Sons Ltd,,-Split-,"1,560.00","1,010,665.66"
,18/06/2022,Expense Transaction (Bank Draft),Mary1631,Field Sports Publishing Inc,,EastX ****2310,"-5,614.21","1,005,051.45"
,18/06/2022,Expense Transaction (Bank Draft),Mary1630,P Higgins & Sons Ltd,,EastX ****2310,"-1,560.00","1,003,491.45"
,18/06/2022,Expense,102835,SRS Freight Ltd,,-Split-,"5,566.94","1,009,058.39"
,21/06/2022,Expense,,Field Sports Publishing Inc,,ADMINISTRATION:Exchange Rate cost,34.77,"1,009,093.16"
,21/06/2022,Expense,9063158796,Parcelforce,,MARKETING/SELLING:Postage and Delivery,"1,089.38","1,010,182.54"
,21/06/2022,Expense,,Parcelforce,,MARKETING/SELLING:Postage and Delivery,45.72,"1,010,228.26"
,21/06/2022,Expense,,William Wild,,Work in Progress,"3,250.00","1,013,478.26"
,21/06/2022,Expense Transaction (Bank Draft),Mary1643,Traditional English Guncases Ltd,,EastX ****2310,"-20,874.00","992,604.26"
,22/06/2022,Expense,21221685,Swarovski Optik,,Work in Progress,"1,494.00","994,098.26"
,22/06/2022,Expense,2.11E+13,West London Shooting School,,PreTransactions,"2,733.60","996,831.86"
,22/06/2022,Expense Transaction (Bank Draft),Mary1632,CA Bookkeeping Services Ltd,,EastX ****2310,-844.8,"995,987.06"
,22/06/2022,Expense Transaction (Bank Draft),Mary1634,Mayfair  Engineering,,EastX ****2310,"-13,860.00","982,127.06"
,23/06/2022,Expense,8400039002,Northwood Group,,Stock in Trnasit,"2,322.00","984,449.06"
,23/06/2022,Expense,8400039483,Northwood Group,,Stock / Inventory Asset,258,"984,707.06"
,23/06/2022,Expense,INV102836,SRS Freight Ltd,Cost of Sales for Sheikh Al-Khalifa/13.05.2021,-Split-,"2,782.74","987,489.80"
,23/06/2022,Expense,INV102834,SRS Freight Ltd,,-Split-,463.99,"987,953.79"
,23/06/2022,Expense,668797,Wbc,,PreTransactions,"5,424.00","993,377.79"
,24/06/2022,Expense,32,BF&D LIMITED,,-Split-,650,"994,027.79"
,24/06/2022,Expense,86,Ray St Ledger & Sons,,-Split-,88.8,"994,116.59"
,24/06/2022,Expense,85,Ray St Ledger & Sons,,-Split-,736.8,"994,853.39"
,25/06/2022,Expense Transaction (Bank Draft),Mary1659,Aerial Direct,,EastX ****2310,-560.4,"994,292.99"
,25/06/2022,Expense Transaction (Bank Draft),Mary1660,Ian Clarke,,EastX ****2310,"-2,348.40","991,944.59"
,25/06/2022,Expense Transaction (Bank Draft),Mary1661,Steve Kelly,,EastX ****2310,"-4,050.00","987,894.59"
,25/06/2022,Expense,5954,Beck Office,,Bookkeeping & Payroll,72,"987,966.59"
,25/06/2022,Expense,Rig002,Ian Moran,,-Split-,"3,500.00","991,466.59"
,25/06/2022,Expense,71788,Harper Office,,ADMINISTRATION:Office Supplies,256.1,"991,722.69"
,25/06/2022,Expense,33,BF&D LIMITED,,-Split-,"5,000.00","996,722.69"
,26/06/2022,Expense,2893,DMC Custom Cartridges,,-Split-,523.75,"997,246.44"
,28/06/2022,Expense,,Propel Finance No 1,,MARKETING/SELLING:Telephone Expense,218.16,"997,464.60"
,28/06/2022,Expense Transaction (Bank Draft),Mary1665,Propel Finance No 1,,EastX ****2310,-218.16,"997,246.44"
,28/06/2022,Expense Transaction (Bank Draft),Mary1662,Tweed Media,,EastX ****2310,"-4,920.00","992,326.44"
,28/06/2022,Expense,60217,Aerial Direct,,MARKETING/SELLING:Telephone Expense,150,"992,476.44"
,29/06/2022,Expense,12,T & D O'Neill,Queen Rifle,Cost of sales,780,"993,256.44"
,29/06/2022,Expense,11,T & D O'Neill,,-Split-,180,"993,436.44"
,29/06/2022,Expense,INV0003434,ElS And Co (Pty) Ltd,,Stock / Inventory Asset,"4,378.00","997,814.44"
,29/06/2022,Expense,847,Snappy Snaps,,ADMINISTRATION:Printing and Reproduction,479.89,"998,294.33"
,30/06/2022,Expense,318,Johnsons & Co Ltd,,Cost of sales,468,"998,762.33"
,30/06/2022,Expense,GD0621,Northwood USA,Exchange Rate - £1 = $1.3848,MARKETING/SELLING:Consultants,"5,108.68","1,003,871.01"
,30/06/2022,Expense Transaction (Bank Draft),9190,Northwood USA,,Apple Account,"-5,108.68","998,762.33"
,30/06/2022,Expense Transaction (Bank Draft),1010,The White Horse,,Business Card,"-1,372.75","997,389.58"
,30/06/2022,Expense Transaction (Bank Draft),1032,Andy Thornton Ltd,,Business Card,-318,"997,071.58"
,30/06/2022,Expense Transaction (Bank Draft),Mary1635,M Mitchell (Gun Makers) Ltd,,EastX ****2310,"-7,020.00","990,051.58"
,30/06/2022,Vendor Credit,2021/117,Northwood Group,,Accruals,"-1,055.25","988,996.33"
,30/06/2022,Expense,2021/119,Northwood Group,,-Split-,"27,362.87","1,016,359.20"
,30/06/2022,Expense,,Derse Inc,,ADMINISTRATION:Exchange Rate cost,30.16,"1,016,389.36"
,30/06/2022,Expense,,Northwood Group,,Shared cost,"1,015.00","1,017,404.36"
,30/06/2022,Expense,75699,Kerast,,-Split-,"1,588.20","1,018,992.56"
,30/06/2022,Expense,,Northwood Group,,Shared cost,"2,636.50","1,021,629.06"
,30/06/2022,Expense Transaction (Bank Draft),1009,BrandCo Branding Ltd,,Business Card,-343.92,"1,021,285.14"
,30/06/2022,Expense Transaction (Bank Draft),1034,MAnoMAno,,Business Card,-47.99,"1,021,237.15"
,30/06/2022,Expense,1808,TimberLake Workshop,,-Split-,"2,821.20","1,024,058.35"
,30/06/2022,Expense Transaction (Bank Draft),Mary1667,Aerial Direct,,EastX ****2310,-184.19,"1,023,874.16"
,30/06/2022,Expense Transaction (Bank Draft),1033,Maisons Du Monde,,Business Card,-153,"1,023,721.16"
,1/7/2022,Expense,80143526,LAMBETH,Waiting for Receipt,ADMINISTRATION:Office Cleaning,69.74,"1,023,790.90"
,1/7/2022,Expense,AVI8572771,DHL,,-Split-,825.89,"1,024,616.79"
,1/7/2022,Expense,,Mark Remmant,,MARKETING/SELLING:Travel Expense,293,"1,024,909.79"
,1/7/2022,Expense,,SRS Freight Ltd,,Cost of sales,"2,693.71","1,027,603.50"
,1/7/2022,Expense,INV102843,SRS Freight Ltd,,-Split-,532.31,"1,028,135.81"
,1/7/2022,Expense,91,Ray St Ledger & Sons,,Work in Progress,361.2,"1,028,497.01"
,1/7/2022,Vendor Credit,8400037864,Northwood Group,,Stock in Trnasit,"-23,909.16","1,004,587.85"
,1/7/2022,Vendor Credit,8400037863,Northwood Group,,Stock in Trnasit,"-68,206.05","936,381.80"
,1/7/2022,Vendor Credit,8400039002,Northwood Group,,Stock in Trnasit,"-2,322.00","934,059.80"
,1/7/2022,Vendor Credit,8400039001,Northwood Group,,Stock in Trnasit,"-10,836.00","923,223.80"
,1/7/2022,Expense Transaction (Bank Draft),9324,Northwood Group,,-Split-,,"923,223.80"
,1/7/2022,Expense Transaction (Bank Draft),9324,Northwood Group,,-Split-,,"923,223.80"
,1/7/2022,Expense Transaction (Bank Draft),9324,Northwood Group,,-Split-,,"923,223.80"
,1/7/2022,Expense Transaction (Bank Draft),Mary1671,M Mitchell (Gun Makers) Ltd,,EastX ****2310,"-7,020.00","916,203.80"
,1/7/2022,Expense Transaction (Bank Draft),9324,Northwood Group,,-Split-,,"916,203.80"
,1/7/2022,Expense Transaction (Bank Draft),Mary1669,Big Yellow Self Storage,,EastX ****2310,"-1,132.88","915,070.92"
,1/7/2022,Expense Transaction (Bank Draft),Mary1670,eon,,EastX ****2310,-3.49,"915,067.43"
,1/7/2022,Expense Transaction (Bank Draft),9315,Royal,,EastX Bank,"-51,282.00","863,785.43"
,1/7/2022,Expense Transaction (Bank Draft),9319,L & O Immobilien GMBH & Co KG,,EastX Bank,"-10,666.12","853,119.31"
,1/7/2022,Expense,8400039002,Northwood Group,,-Split-,"2,322.00","855,441.31"
,1/7/2022,Expense,600566,Traditional English Guncases Ltd,,Work in Progress,"3,000.00","858,441.31"
,1/7/2022,Expense,,Barton Gun Work,,-Split-,180,"858,621.31"
,1/7/2022,Expense,80147430,LAMBETH,,ADMINISTRATION:Office Cleaning,160.65,"858,781.96"
,1/7/2022,Expense,8400039001,Northwood Group,,-Split-,"10,836.00","869,617.96"
,1/7/2022,Expense,8400037863,Northwood Group,,-Split-,"68,206.05","937,824.01"
,1/7/2022,Expense,,SNT Adventure Brands LLC,,-Split-,808.39,"938,632.40"
,1/7/2022,Expense,8400039483,Northwood Group,,Work in Progress,258,"938,890.40"
,1/7/2022,Expense,GL7662D,CTS (GB) Limited,,-Split-,"1,162.94","940,053.34"
,1/7/2022,Expense,,Barton Gun Work,,-Split-,257.76,"940,311.10"
,1/7/2022,Expense,,Barton Gun Work,,Work in Progress,96,"940,407.10"
,1/7/2022,Expense,45205,Ernst Apel GMBH,Waiting for Receipt 2818  EUR,Stock / Inventory Asset,"2,427.09","942,834.19"
,1/7/2022,Expense,,L & O Immobilien GMBH & Co KG,,ADMINISTRATION:Rent & Rates Expense,"10,666.11","953,500.30"
,1/7/2022,Expense,2783,Julian & Sons,Exchange rate - £1 = $1.3848,Storage,909.72,"954,410.02"
,1/7/2022,Expense,75479,Kerast,,-Split-,234,"954,644.02"
,1/7/2022,Expense,2544,Arms Restoration Services,,Work in Progress,"1,020.00","955,664.02"
,1/7/2022,Expense,GL7663,CTS (GB) Limited,,MARKETING/SELLING:Import Duty,50,"955,714.02"
,1/7/2022,Expense,GL7677,CTS (GB) Limited,,-Split-,"1,155.00","956,869.02"
,1/7/2022,Expense,159116203,Worldpay,,-Split-,167.72,"957,036.74"
,1/7/2022,Expense,FLODUK100940,Fly odyssey UK Ltd,,MARKETING/SELLING:Marketing,550,"957,586.74"
,1/7/2022,Expense,600565,Traditional English Guncases Ltd,,Work in Progress,"4,380.00","961,966.74"
,1/7/2022,Expense,17743,GWT Media,,ADMINISTRATION:Computer and Internet Expenses,225,"962,191.74"
,1/7/2022,Expense,8400037864,Northwood Group,,-Split-,"23,909.16","986,100.90"
,1/7/2022,Expense,1746,A T Miles,,-Split-,275.3,"986,376.20"
,1/7/2022,Expense,40951,Irvine Springs Company Ltd,,-Split-,481.2,"986,857.40"
,1/7/2022,Expense,1167,Cooper Roberts,,Storage,270,"987,127.40"
,2/7/2022,Expense Transaction (Bank Draft),Mary1637,LAMBETH,,EastX ****2310,-160.25,"986,967.15"
,2/7/2022,Expense Transaction (Bank Draft),Mary1636,London Barrel Maker,,EastX ****2310,"-3,000.00","983,967.15"
,2/7/2022,Expense Transaction (Bank Draft),Mary1641,Phil Coggan,,EastX ****2310,"-28,500.00","955,467.15"
,2/7/2022,Expense Transaction (Bank Draft),Mary1640,CTS (GB) Limited,,EastX ****2310,"-1,162.94","954,304.21"
,2/7/2022,Expense Transaction (Bank Draft),Mary1638,LAMBETH,,EastX ****2310,-69.74,"954,234.47"
,2/7/2022,Expense,1087,SonySports Press Limited,,MARKETING/SELLING:Marketing,"1,794.00","956,028.47"
,2/7/2022,Expense,6564,CA Bookkeeping Services Ltd,,Bookkeeping & Payroll,844.8,"956,873.27"
,2/7/2022,Expense,705046,Jay Spark Co Ltd,,-Split-,52.46,"956,925.73"
,2/7/2022,Expense Transaction (Bank Draft),Mary1639,CTS (GB) Limited,,EastX ****2310,-50,"956,875.73"
,5/7/2022,Expense Transaction (Bank Draft),Mary1645,Jamie,,EastX ****2310,-277.79,"956,597.94"
,5/7/2022,Expense Transaction (Bank Draft),Mary1646,Kerast,,EastX ****2310,-408,"956,189.94"
,5/7/2022,Expense Transaction (Bank Draft),Mary1644,A G Sinnett,,EastX ****2310,-259.87,"955,930.07"
,5/7/2022,Expense,102863,SRS Freight Ltd,,-Split-,481.5,"956,411.57"
,5/7/2022,Expense,R17-04-53,IDR Associates,,-Split-,"1,465.78","957,877.35"
,5/7/2022,Expense,,Jamie,,-Split-,470.31,"958,347.66"
,5/7/2022,Expense,2.11E+13,Northwood Group UK Vendor,,PreTransactions,274.8,"958,622.46"
,5/7/2022,Expense,68340,ARC,,ADMINISTRATION:Office Supplies,75.99,"958,698.45"
,5/7/2022,Expense,1172,Cooper Roberts,,-Split-,"17,304.00","976,002.45"
,6/7/2022,Expense,Ancient16,Dirty laundry,,ADMINISTRATION:Cleaning Supplies,76.8,"976,079.25"
,6/7/2022,Expense,102887,SRS Freight Ltd,,-Split-,"2,039.31","978,118.56"
,6/7/2022,Expense,,A G Sinnett,,-Split-,160.12,"978,278.68"
,7/7/2022,Expense Transaction (Bank Draft),Mary1674,Rentokil,,EastX ****2310,-352.78,"977,925.90"
,7/7/2022,Expense Transaction (Bank Draft),Mary1673,GWT Media,,EastX ****2310,-45,"977,880.90"
,7/7/2022,Expense,ORD05198,Durable Fasteners Ltd,Waiting for Receipt,Cost of sales,214.8,"978,095.70"
,7/7/2022,Expense,2021-11050,Triebel GMBH,1 EUR - £0.8581,-Split-,"1,886.97","979,982.67"
,7/7/2022,Expense,3146,IPS Gunmaking Ltd,,Work in Progress,"1,873.00","981,855.67"
,7/7/2022,Expense Transaction (Bank Draft),9320,eon,,EastX Bank,-255.5,"981,600.17"
,8/7/2022,Expense Transaction (Bank Draft),Mary1668,GMK,,EastX ****2310,-391.09,"981,209.08"
,8/7/2022,Expense,2021/067,Top Blades International,,-Split-,"4,680.00","985,889.08"
,8/7/2022,Expense,2021-0050,Revolution Wines,,MARKETING/SELLING:Postage and Delivery,38.4,"985,927.48"
,8/7/2022,Expense,210701,Mayfair  Engineering,,-Split-,"3,606.00","989,533.48"
,9/7/2022,Expense,,Jerome  Lannoue,1 Eur = £0.85819,-Split-,"1,927.66","991,461.14"
,10/7/2022,Expense,,David E Josey,,Work in Progress,"4,348.00","995,809.14"
,12/7/2022,Expense Transaction (Bank Draft),Mary1676,Frederique Lepinois,,EastX ****2310,"-12,715.00","983,094.14"
,12/7/2022,Expense Transaction (Bank Draft),9318,ElS And Co (Pty) Ltd,,EastX Bank,"-4,378.00","978,716.14"
,12/7/2022,Expense,1885,L W Butler,,Work in Progress,822,"979,538.14"
,12/7/2022,Expense,,Barton Gun Work,,-Split-,381.6,"979,919.74"
,12/7/2022,Expense,INV102900,SRS Freight Ltd,,-Split-,865.43,"980,785.17"
,12/7/2022,Expense,,Frederique Lepinois,,ADMINISTRATION:Bank & card charges,15,"980,800.17"
,13/07/2022,Expense Transaction (Bank Draft),Mary1690,DHL,,EastX ****2310,"-2,656.72","978,143.45"
,13/07/2022,Expense Transaction (Bank Draft),Mary1691,Irvine Springs Company Ltd,,EastX ****2310,-481.2,"977,662.25"
,13/07/2022,Expense,PRO/117309,BrandCo Branding Ltd,Waiting for Receipt,-Split-,419.28,"978,081.53"
,13/07/2022,Expense,80148445,LAMBETH,,ADMINISTRATION:Office Cleaning,160.65,"978,242.18"
,13/07/2022,Expense,1210JRL,Laser Welding Services,,-Split-,223.38,"978,465.56"
,13/07/2022,Expense,SALES ORDER,Wbc,,-Split-,117.54,"978,583.10"
,13/07/2022,Expense,,Jamie,,MARKETING/SELLING:Petrol,174.54,"978,757.64"
,14/07/2022,Expense Transaction (Bank Draft),Mary1678,Cooper Roberts,,EastX ****2310,"-17,304.00","961,453.64"
,14/07/2022,Expense Transaction (Bank Draft),Mary1677,Top Blades International,,EastX ****2310,"-4,680.00","956,773.64"
,15/07/2022,Expense,23,Royal,,Work in Progress,"72,000.00","1,028,773.64"
,15/07/2022,Expense,1087,SonySports Press Limited,,MARKETING/SELLING,"1,794.00","1,030,567.64"
,15/07/2022,Expense,17630,Kynamco Limited,,-Split-,28.44,"1,030,596.08"
,15/07/2022,Expense,3640,Tweed Media,,-Split-,"8,308.07","1,038,904.15"
,15/07/2022,Expense,44504,The Company of Gunmakers,,-Split-,"2,784.64","1,041,688.79"
,15/07/2022,Expense,425028,Aerial Direct,,MARKETING/SELLING:Telephone Expense,76.52,"1,041,765.31"
,15/07/2022,Expense,1212JRL,Laser Welding Services,,-Split-,946.15,"1,042,711.46"
,15/07/2022,Expense,INV102907,SRS Freight Ltd,,-Split-,"1,635.72","1,044,347.18"
,15/07/2022,Expense Transaction (Bank Draft),Mary1695,Aerial Direct,,EastX ****2310,-180,"1,044,167.18"
,15/07/2022,Expense Transaction (Bank Draft),Mary1694,LAMBETH,,EastX ****2310,-390.64,"1,043,776.54"
,16/07/2022,Expense,AVI8648684,DHL,,-Split-,70.32,"1,043,846.86"
,16/07/2022,Expense,,Aerial Direct,,MARKETING/SELLING:Telephone Expense,137.67,"1,043,984.53"
,16/07/2022,Expense,107,Karen Marion Wallace,,-Split-,"3,000.00","1,046,984.53"
,18/07/2022,Expense,RE0121,Holzwelt Cases,,Stock / Inventory Asset,321.47,"1,047,306.00"
,19/07/2022,Expense Transaction (Bank Draft),Mary1680,CA Bookkeeping Services Ltd,,EastX ****2310,-844.8,"1,046,461.20"
,19/07/2022,Expense Transaction (Bank Draft),Mary1700,Jamie,,EastX ****2310,-470.31,"1,045,990.89"
,19/07/2022,Expense Transaction (Bank Draft),Mary1698,Mark Remmant,,EastX ****2310,-293,"1,045,697.89"
,19/07/2022,Expense Transaction (Bank Draft),Mary1697,Kerast,,EastX ****2310,"-1,588.20","1,044,109.69"
,19/07/2022,Expense,44508,The Company of Gunmakers,,Work in Progress,48,"1,044,157.69"
,19/07/2022,Expense,97,Ray St Ledger & Sons,,Work in Progress,"1,678.80","1,045,836.49"
,19/07/2022,Expense,20792,TMC Ltd,,Furniture and Fixtures,"17,405.40","1,063,241.89"
,19/07/2022,Expense Transaction (Bank Draft),Mary1681,A G Sinnett,,EastX ****2310,-160.12,"1,063,081.77"
,19/07/2022,Expense,INV102914,SRS Freight Ltd,,-Split-,779.87,"1,063,861.64"
,19/07/2022,Expense,20793,TMC Ltd,,MARKETING/SELLING,"3,184.80","1,067,046.44"
,19/07/2022,Expense,21225215,Swarovski Optik,,-Split-,"2,775.00","1,069,821.44"
,19/07/2022,Expense,INV-1821,TimberLake Workshop,,-Split-,"1,668.96","1,071,490.40"
,20/07/2022,Expense,INV102918,SRS Freight Ltd,,-Split-,938.63,"1,072,429.03"
,20/07/2022,Expense,INV102917,SRS Freight Ltd,,-Split-,"5,432.15","1,077,861.18"
,20/07/2022,Expense,35774,Argent Steel,,-Split-,392.4,"1,078,253.58"
,20/07/2022,Expense Transaction (Bank Draft),Mary1682,Ray St Ledger & Sons,,EastX ****2310,"-3,092.40","1,075,161.18"
,20/07/2022,Expense Transaction (Bank Draft),Mary1701,Natraj Publishers,,EastX ****2310,-272.5,"1,074,888.68"
,20/07/2022,Expense Transaction (Bank Draft),Mary1703,DHL,,EastX ****2310,-70.32,"1,074,818.36"
,21/07/2022,Expense,INV20642,EtherLive LTD,,MARKETING/SELLING,374.4,"1,075,192.76"
,21/07/2022,Expense Transaction (Bank Draft),Mary1704,Parcelforce,,EastX ****2310,"-1,089.38","1,074,103.38"
,22/07/2022,Expense,,Jamie,,-Split-,472.37,"1,074,575.75"
,22/07/2022,Expense Transaction (Bank Draft),Mary2188,Lothar Walther,,-Split-,,"1,074,575.75"
,22/07/2022,Expense,61802,Manchester Automatic Machining,,-Split-,850.2,"1,075,425.95"
,22/07/2022,Expense Transaction (Bank Draft),Mary1683,Fly odyssey UK Ltd,,EastX ****2310,-550,"1,074,875.95"
,22/07/2022,Expense,INV102931,SRS Freight Ltd,,-Split-,"1,183.46","1,076,059.41"
,23/07/2022,Expense Transaction (Bank Draft),Mary1685,TMC Ltd,,EastX ****2310,"-17,405.40","1,058,654.01"
,23/07/2022,Expense,44519,The Company of Gunmakers,,-Split-,"1,142.77","1,059,796.78"
,23/07/2022,Expense Transaction (Bank Draft),Mary1686,Alan Rhone lTD,,EastX ****2310,-819.2,"1,058,977.58"
,25/07/2022,Expense,1,JOHN HALSALL,,MARKETING/SELLING,700,"1,059,677.58"
,25/07/2022,Expense,,Marc Newton Expenses,,MARKETING/SELLING:Subsistasnce and Entertainment expenses,71,"1,059,748.58"
,25/07/2022,Expense,5980,Beck Office,,Bookkeeping & Payroll,72,"1,059,820.58"
,26/07/2022,Expense,210703,Mayfair  Engineering,,-Split-,"7,092.00","1,066,912.58"
,26/07/2022,Expense Transaction (Bank Draft),Mary1687,SRS Freight Ltd,,EastX ****2310,"-5,566.94","1,061,345.64"
,26/07/2022,Expense Transaction (Bank Draft),Mary1688,BF&D LIMITED,,EastX ****2310,"-1,000.00","1,060,345.64"
,27/07/2022,Expense,AVI8672516,DHL,,-Split-,272.88,"1,060,618.52"
,27/07/2022,Expense,,A G Sinnett,,ADMINISTRATION:Office Supplies,345.78,"1,060,964.30"
,28/07/2022,Expense,210705,Mayfair  Engineering,,-Split-,195.96,"1,061,160.26"
,28/07/2022,Expense Transaction (Bank Draft),Mary1713,Worldpay,,EastX ****2310,-167.72,"1,060,992.54"
,28/07/2022,Expense Transaction (Bank Draft),Mary1716,Propel Finance No 1,,EastX ****2310,-218.16,"1,060,774.38"
,29/07/2022,Expense,8400046853,Northwood Group,,-Split-,"78,291.05","1,139,065.43"
,29/07/2022,Expense,8400046854,Northwood Group,,-Split-,"1,504.50","1,140,569.93"
,29/07/2022,Expense,RE-202107/14074,Karl Beier,,-Split-,421.95,"1,140,991.88"
,29/07/2022,Expense,1837,TimberLake Workshop,,-Split-,218.02,"1,141,209.90"
,29/07/2022,Expense,730267,Propel Finance No 1,,MARKETING/SELLING:Telephone Expense,218.16,"1,141,428.06"
,29/07/2022,Expense Transaction (Bank Draft),Mary1708,William Wild,,EastX ****2310,"-3,250.00","1,138,178.06"
,29/07/2022,Expense Transaction (Bank Draft),Mary1706,Tweed Media,,EastX ****2310,"-8,308.07","1,129,869.99"
,29/07/2022,Expense Transaction (Bank Draft),Mary1707,BF&D LIMITED,,EastX ****2310,"-4,650.00","1,125,219.99"
,30/07/2022,Expense,72247,Harper Office,,ADMINISTRATION:Office Supplies,217.03,"1,125,437.02"
,30/07/2022,Expense Transaction (Bank Draft),Mary1712,Julian & Sons,,EastX ****2310,-909.72,"1,124,527.30"
,30/07/2022,Expense Transaction (Bank Draft),Mary1711,Broadbent Leather goods,,EastX ****2310,-682.5,"1,123,844.80"
,30/07/2022,Expense,72246,Harper Office,,ADMINISTRATION:Office Supplies,267.6,"1,124,112.40"
,30/07/2022,Expense,21-4324,John Ross,,MARKETING/SELLING,240,"1,124,352.40"
,30/07/2022,Expense,992,T F Wood & Son,,-Split-,"2,850.00","1,127,202.40"
,30/07/2022,Expense Transaction (Bank Draft),Mary1710,SRS Freight Ltd,,EastX ****2310,"-6,562.71","1,120,639.69"
,31/07/2022,Expense Transaction (Bank Draft),1148,Snappy Snaps,,Business Card,-479.89,"1,120,159.80"
,31/07/2022,Expense,GD0721,Northwood USA,,MARKETING/SELLING:Consultants,"6,148.60","1,126,308.40"
,31/07/2022,Expense,,Northwood Group,,Shared cost,"1,015.00","1,127,323.40"
,31/07/2022,Expense,,Northwood Group,,Shared cost,"2,636.50","1,129,959.90"
,31/07/2022,Expense,,T & D O'Neill,,-Split-,240,"1,130,199.90"
,31/07/2022,Expense,,T & D O'Neill,,Cost of sales,"1,760.00","1,131,959.90"
,31/07/2022,Expense,163985208,Worldpay,,-Split-,175.41,"1,132,135.31"
,1/8/2022,Expense,600589,Traditional English Guncases Ltd,Cost of sale for Receipt 12424 Northwood Norway,Cost of sales,144,"1,132,279.31"
,1/8/2022,Expense,44475,The Company of Gunmakers,,-Split-,60,"1,132,339.31"
,1/8/2022,Expense,600598,Traditional English Guncases Ltd,,-Split-,"1,716.00","1,134,055.31"
,1/8/2022,Expense,2.11E+13,Northwood Group UK Vendor,,MARKETING/SELLING:Postage and Delivery,61.2,"1,134,116.51"
,1/8/2022,Expense,,Tamas Szarka,,MARKETING/SELLING:Staff welfare and Training,24.5,"1,134,141.01"
,1/8/2022,Expense,AN1388396,Redhead International,Receipt dated 7 July 21,MARKETING/SELLING:Postage and Delivery,50,"1,134,191.01"
,1/8/2022,Expense,44487,The Company of Gunmakers,,-Split-,78,"1,134,269.01"
,1/8/2022,Expense,2.11E+13,Northwood Group,COS - To Carl King Receipt ref: 12488,Cost of sales,274.8,"1,134,543.81"
,1/8/2022,Expense,600597,Traditional English Guncases Ltd,,-Split-,"1,464.00","1,136,007.81"
,1/8/2022,Expense,1747,A T Miles,,-Split-,800,"1,136,807.81"
,1/8/2022,Expense,1180,Cooper Roberts,,Storage,540,"1,137,347.81"
,1/8/2022,Expense,17944,GWT Media,,ADMINISTRATION:Computer and Internet Expenses,217.8,"1,137,565.61"
,1/8/2022,Expense,103,Coggan Simon Engraver,,Work in Progress,816,"1,138,381.61"
,1/8/2022,Expense,1159,Cooper Roberts,,PreTransactions,"4,200.00","1,142,581.61"
,1/8/2022,Expense,152,Nigel Westway,,-Split-,"3,065.00","1,145,646.61"
,1/8/2022,Expense,101RIG,FOREMAN LOGISTICS,,MARKETING/SELLING,"1,296.00","1,146,942.61"
,1/8/2022,Expense,17860,GWT Media,,ADMINISTRATION:Computer and Internet Expenses,45,"1,146,987.61"
,1/8/2022,Expense,102,TRADE SECRET,,-Split-,245,"1,147,232.61"
,1/8/2022,Expense,AN1379413,Redhead International,Receipt dated 28 June 21,MARKETING/SELLING:Postage and Delivery,50,"1,147,282.61"
,1/8/2022,Expense,AVI8711332,DHL,,-Split-,"1,017.33","1,148,299.94"
,1/8/2022,Expense,NI147922,Big Yellow Self Storage,,-Split-,"1,132.88","1,149,432.82"
,1/8/2022,Expense,6710,Field Sports Publishing Inc,£1 = $1.391,MARKETING/SELLING,"2,730.68","1,152,163.50"
,1/8/2022,Expense,AN1343718,Redhead International,Receipt dated 20 Apr 21,MARKETING/SELLING:Postage and Delivery,50,"1,152,213.50"
,1/8/2022,Expense,HV69MFA,Ford,,MARKETING/SELLING:Car Rental,550.42,"1,152,763.92"
,1/8/2022,Expense,600590,Traditional English Guncases Ltd,Cost of sale for Receipt 12447 V Daigle,Cost of sales,960,"1,153,723.92"
,1/8/2022,Expense,460,London Barrel Maker,,Work in Progress,"3,240.00","1,156,963.92"
,1/8/2022,Expense,910035900,Hoffmann Group,,Materials & Tools,27.55,"1,156,991.47"
,2/8/2022,Expense,,JP Smithson Ltd,,ADMINISTRATION:Exchange Rate cost,41.87,"1,157,033.34"
,2/8/2022,Expense,348,IPS Gunmaking Ltd,,Work in Progress,"3,337.00","1,160,370.34"
,2/8/2022,Expense Transaction (Bank Draft),Mary1765,Big Yellow Self Storage,,EastX ****2310,"-1,132.88","1,159,237.46"
,2/8/2022,Expense Transaction (Bank Draft),9326,L & O Immobilien GMBH & Co KG,,EastX Bank,"-10,666.11","1,148,571.35"
,2/8/2022,Expense Transaction (Bank Draft),Mary1727,JP Smithson Ltd,,EastX ****2310,-660.12,"1,147,911.23"
,2/8/2022,Expense,,Barton Gun Work,,-Split-,753.6,"1,148,664.83"
,2/8/2022,Expense,,Jerome  Lannoue,,-Split-,"3,825.00","1,152,489.83"
,2/8/2022,Expense,INV0003480,ElS And Co (Pty) Ltd,,-Split-,"1,562.00","1,154,051.83"
,2/8/2022,Expense Transaction (Bank Draft),1063,Marc Newton Expenses,,Business Card,-71,"1,153,980.83"
,3/8/2022,Expense,69066,ARC,,ADMINISTRATION:Office Supplies,68.46,"1,154,049.29"
,4/8/2022,Expense Transaction (Bank Draft),Mary1718,TMC Ltd,,EastX ****2310,"-3,184.80","1,150,864.49"
,4/8/2022,Expense,1001/00082290,Edgar Brothers,,-Split-,666.02,"1,151,530.51"
,4/8/2022,Expense,2587,First Sight Design Ltd,,MARKETING/SELLING,192,"1,151,722.51"
,5/8/2022,Expense,6654,CA Bookkeeping Services Ltd,,Bookkeeping & Payroll,"1,056.00","1,152,778.51"
,5/8/2022,Expense,1851,TimberLake Workshop,,-Split-,224.4,"1,153,002.91"
,5/8/2022,Expense,8400048429,Northwood Group,,Shipping & Freight,111.48,"1,153,114.39"
,5/8/2022,Expense,26/05/4388,Giclee UK Ltd,,-Split-,588.5,"1,153,702.89"
,5/8/2022,Expense,33,Steve Kelly,,-Split-,"5,850.00","1,159,552.89"
,6/8/2022,Expense Transaction (Bank Draft),Mary1730,SRS Freight Ltd,,EastX ****2310,"-13,356.07","1,146,196.82"
,6/8/2022,Expense,72334,Harper Office,,ADMINISTRATION:Office Supplies,34.14,"1,146,230.96"
,6/8/2022,Expense,8400048644,Northwood Group,,Shipping & Freight,718.62,"1,146,949.58"
,6/8/2022,Expense,21512568,Rentokil,,MARKETING/SELLING:Repair and maintenance,352.78,"1,147,302.36"
,6/8/2022,Expense Transaction (Bank Draft),Mary1723,David E Josey,,EastX ****2310,"-4,348.00","1,142,954.36"
,6/8/2022,Expense Transaction (Bank Draft),Mary1722,JOHN HALSALL,,EastX ****2310,-700,"1,142,254.36"
,6/8/2022,Expense Transaction (Bank Draft),Mary1721,IDR Associates,,EastX ****2310,"-1,465.78","1,140,788.58"
,9/8/2022,Expense Transaction (Bank Draft),Mary1768,SNT Adventure Brands LLC,,EastX ****2310,"-1,801.87","1,138,986.71"
,9/8/2022,Expense Transaction (Bank Draft),Mary1758,GWT Media,,EastX ****2310,-532.8,"1,138,453.91"
,9/8/2022,Expense Transaction (Bank Draft),Mary1754,Arms Restoration Services,,EastX ****2310,"-1,020.00","1,137,433.91"
,9/8/2022,Expense Transaction (Bank Draft),Mary1736,DMC Custom Cartridges,,EastX ****2310,-781.75,"1,136,652.16"
,9/8/2022,Expense Transaction (Bank Draft),1168,Kynamco Limited,,Business Card,-28.44,"1,136,623.72"
,9/8/2022,Expense Transaction (Bank Draft),Mary1767,Karl Beier,,EastX ****2310,-446.07,"1,136,177.65"
,9/8/2022,Expense Transaction (Bank Draft),Mary1747,TimberLake Workshop,,EastX ****2310,"-4,847.38","1,131,330.27"
,9/8/2022,Expense Transaction (Bank Draft),Mary1762,Jerome  Lannoue,,EastX ****2310,-789.91,"1,130,540.36"
,9/8/2022,Expense Transaction (Bank Draft),9191,Northwood USA,,Apple Account,"-6,148.60","1,124,391.76"
,9/8/2022,Expense Transaction (Bank Draft),Mary1746,Coggan Simon Engraver,,EastX ****2310,-816,"1,123,575.76"
,9/8/2022,Expense Transaction (Bank Draft),Mary1761,Laser Welding Services,,EastX ****2310,"-1,327.75","1,122,248.01"
,9/8/2022,Expense Transaction (Bank Draft),Mary1751,Manchester Automatic Machining,,EastX ****2310,"-1,236.60","1,121,011.41"
,9/8/2022,Expense Transaction (Bank Draft),Mary1753,Phil Coggan,,EastX ****2310,"-5,000.00","1,116,011.41"
,9/8/2022,Expense Transaction (Bank Draft),Mary1740,Jay Spark Co Ltd,,EastX ****2310,-52.46,"1,115,958.95"
,9/8/2022,Expense Transaction (Bank Draft),Mary1764,Jerome  Lannoue,,EastX ****2310,"-3,840.00","1,112,118.95"
,9/8/2022,Expense Transaction (Bank Draft),Mary1737,Harper Office,,EastX ****2310,-740.73,"1,111,378.22"
,9/8/2022,Expense Transaction (Bank Draft),Mary1744,Barton Gun Work,,EastX ****2310,"-1,668.96","1,109,709.26"
,9/8/2022,Expense Transaction (Bank Draft),Mary1769,SNT Adventure Brands LLC,,EastX ****2310,-728.08,"1,108,981.18"
,9/8/2022,Expense Transaction (Bank Draft),Mary1749,Ian Moran,,EastX ****2310,"-3,500.00","1,105,481.18"
,9/8/2022,Expense Transaction (Bank Draft),Mary1733,A T Miles,,EastX ****2310,"-2,281.90","1,103,199.28"
,9/8/2022,Expense Transaction (Bank Draft),9325,Royal,,EastX Bank,"-72,000.00","1,031,199.28"
,9/8/2022,Expense Transaction (Bank Draft),Mary1755,Brock & Norris,,EastX ****2310,-488.42,"1,030,710.86"
,9/8/2022,Expense Transaction (Bank Draft),Mary1741,Karen Marion Wallace,,EastX ****2310,"-3,000.00","1,027,710.86"
,9/8/2022,Expense Transaction (Bank Draft),Mary1735,Jamie,,EastX ****2310,-646.91,"1,027,063.95"
,9/8/2022,Expense Transaction (Bank Draft),Mary1756,Revolution Wines,,EastX ****2310,-37.4,"1,027,026.55"
,9/8/2022,Expense Transaction (Bank Draft),Mary1757,ARC,,EastX ****2310,-183.37,"1,026,843.18"
,9/8/2022,Expense Transaction (Bank Draft),Mary1743,Ray St Ledger & Sons,,EastX ****2310,"-4,399.20","1,022,443.98"
,9/8/2022,Expense Transaction (Bank Draft),Mary1739,John Ross,,EastX ****2310,-240,"1,022,203.98"
,9/8/2022,Expense Transaction (Bank Draft),Mary1745,Beck Office,,EastX ****2310,-216,"1,021,987.98"
,9/8/2022,Expense Transaction (Bank Draft),Mary1742,Kerast,,EastX ****2310,-234,"1,021,753.98"
,9/8/2022,Expense Transaction (Bank Draft),Mary1763,Jerome  Lannoue,,EastX ****2310,"-1,137.75","1,020,616.23"
,9/8/2022,Expense Transaction (Bank Draft),Mary1731,Nigel Westway,,EastX ****2310,"-3,065.00","1,017,551.23"
,9/8/2022,Expense Transaction (Bank Draft),Mary1748,First Sight Design Ltd,,EastX ****2310,-192,"1,017,359.23"
,9/8/2022,Expense Transaction (Bank Draft),Mary1734,A G Sinnett,,EastX ****2310,-345.78,"1,017,013.45"
,9/8/2022,Expense Transaction (Bank Draft),Mary1732,John Whitfield,,EastX ****2310,"-1,060.00","1,015,953.45"
,9/8/2022,Expense Transaction (Bank Draft),Mary1752,Mayfair  Engineering,,EastX ****2310,"-3,606.00","1,012,347.45"
,9/8/2022,Vendor Credit,,SNT Adventure Brands LLC,,ADMINISTRATION:Exchange Rate cost,-80.31,"1,012,267.14"
,9/8/2022,Expense,,Karl Beier,,ADMINISTRATION:Exchange Rate cost,24.12,"1,012,291.26"
,9/8/2022,Expense,,Hambrusch,,ADMINISTRATION:Exchange Rate cost,25.01,"1,012,316.27"
,9/8/2022,Expense,,SNT Adventure Brands LLC,,ADMINISTRATION:Exchange Rate cost,56.87,"1,012,373.14"
,9/8/2022,Expense,INV102970,SRS Freight Ltd,,-Split-,436.5,"1,012,809.64"
,9/8/2022,Expense,2021-11229,Triebel GMBH,,Machinery,260.8,"1,013,070.44"
,9/8/2022,Expense,CN0014361,Redhead International,,MARKETING/SELLING:Postage and Delivery,"15,543.33","1,028,613.77"
,10/8/2022,Expense Transaction (Bank Draft),9331,ElS And Co (Pty) Ltd,,EastX Bank,"-1,562.00","1,027,051.77"
,10/8/2022,Expense,180,Fox & Co Bespokw Ltd,,-Split-,186,"1,027,237.77"
,10/8/2022,Expense Transaction (Bank Draft),9332,Hibo Industies (China) Co.Ltd,,EastX Bank,"-3,603.17","1,023,634.60"
,10/8/2022,Expense Transaction (Bank Draft),Mary1775,T & D O'Neill,,EastX ****2310,"-2,960.00","1,020,674.60"
,10/8/2022,Expense Transaction (Bank Draft),Mary1759,GWT Media,,EastX ****2310,-45,"1,020,629.60"
,10/8/2022,Expense Transaction (Bank Draft),Mary1778,Johnsons & Co Ltd,,EastX ****2310,-468,"1,020,161.60"
,10/8/2022,Expense Transaction (Bank Draft),Mary1776,Worldpay,,EastX ****2310,-175,"1,019,986.60"
,10/8/2022,Expense Transaction (Bank Draft),Mary1738,Harper Office,,EastX ****2310,-34.14,"1,019,952.46"
,10/8/2022,Expense Transaction (Bank Draft),Mary1779,T F Wood & Son,,EastX ****2310,"-2,850.00","1,017,102.46"
,10/8/2022,Expense Transaction (Bank Draft),Mary1773,The Gun Trade Association,,EastX ****2310,-360,"1,016,742.46"
,10/8/2022,Expense Transaction (Bank Draft),Mary1774,Ruag Ammotec (UK) Ltd,,EastX ****2310,"-1,592.84","1,015,149.62"
,10/8/2022,Expense,,Triebel GMBH,,ADMINISTRATION:Exchange Rate cost,39.4,"1,015,189.02"
,10/8/2022,Expense,,Hibo Industies (China) Co.Ltd,,ADMINISTRATION:Exchange Rate cost,611.95,"1,015,800.97"
,10/8/2022,Expense,INV-1862,TimberLake Workshop,,-Split-,412.8,"1,016,213.77"
,10/8/2022,Expense Transaction (Bank Draft),Mary1782,The Company of Gunmakers,,EastX ****2310,"-4,439.37","1,011,774.40"
,10/8/2022,Expense Transaction (Bank Draft),Mary1772,Triebel GMBH,,EastX ****2310,"-1,926.37","1,009,848.03"
,10/8/2022,Expense Transaction (Bank Draft),Mary1771,Ernst Apel GMBH,,EastX ****2310,"-2,464.41","1,007,383.62"
,10/8/2022,Expense Transaction (Bank Draft),Mary1760,L W Butler,,EastX ****2310,-822,"1,006,561.62"
,10/8/2022,Expense Transaction (Bank Draft),Mary1777,Swarovski Optik,,EastX ****2310,"-4,269.00","1,002,292.62"
,10/8/2022,Expense,,Ernst Apel GMBH,,ADMINISTRATION:Exchange Rate cost,37.32,"1,002,329.94"
,10/8/2022,Expense Transaction (Bank Draft),Mary1770,Hambrusch,,EastX ****2310,"-1,875.09","1,000,454.85"
,11/8/2022,Expense,8883754,Chubb Fire & Security Ltd,,MARKETING/SELLING:Repair and maintenance,218.83,"1,000,673.68"
,11/8/2022,Expense,6,Ray St Ledger & Sons,Waiting for corrected Receipt,-Split-,811.2,"1,001,484.88"
,11/8/2022,Expense,HBIV21158 dif,Hibo Industies (China) Co.Ltd,"Initial Receipt HBINV21158 posted for $4,910 was amended and the difference of $1,500 posted here.",Stock / Inventory Asset,"1,300.00","1,002,784.88"
,12/8/2022,Expense,ATA21-0042,CARS Classic Automotive Relocation Services,,-Split-,607.8,"1,003,392.68"
,13/08/2022,Expense,1224JRL,Laser Welding Services,,-Split-,159,"1,003,551.68"
,15/08/2022,Expense,3654,Tweed Media,,MARKETING/SELLING:Marketing,"4,800.00","1,008,351.68"
,16/08/2022,Expense,INV102990,SRS Freight Ltd,,-Split-,"2,151.74","1,010,503.42"
,16/08/2022,Expense,INV102992,SRS Freight Ltd,,-Split-,689.25,"1,011,192.67"
,16/08/2022,Expense Transaction (Bank Draft),Mary1786,Buck's Club Limited,,EastX ****2310,-241.25,"1,010,951.42"
,16/08/2022,Expense,INV102991,SRS Freight Ltd,,-Split-,683.88,"1,011,635.30"
,16/08/2022,Expense,9063484176,Parcelforce,,MARKETING/SELLING:Postage and Delivery,10.98,"1,011,646.28"
,17/08/2022,Expense,H1A309E7E9,eon,,ADMINISTRATION:Utilities,15.62,"1,011,661.90"
,17/08/2022,Expense,44570,The Company of Gunmakers,,-Split-,92.1,"1,011,754.00"
,17/08/2022,Expense Transaction (Bank Draft),9193,Northwood Group UK Vendor,,Apple Account,"-2,764.50","1,008,989.50"
,17/08/2022,Expense Transaction (Bank Draft),Mary1784,Steve Kelly,,EastX ****2310,"-5,850.00","1,003,139.50"
,17/08/2022,Expense Transaction (Bank Draft),Mary1785,SNT Adventure Brands LLC,,-Split-,,"1,003,139.50"
,17/08/2022,Expense Transaction (Bank Draft),9329,Northwood Group,,EastX Bank,"-51,705.36","951,434.14"
,17/08/2022,Expense Transaction (Bank Draft),Mary1783,Aform Tooling Limited,,EastX ****2310,"-10,944.00","940,490.14"
,17/08/2022,Expense Transaction (Bank Draft),9192,Northwood Group,,Apple Account,"-16,107.00","924,383.14"
,18/08/2022,Expense,,Parcelforce,,MARKETING/SELLING:Postage and Delivery,518.93,"924,902.07"
,18/08/2022,Expense,426162,Aerial Direct,,MARKETING/SELLING:Telephone Expense,167.23,"925,069.30"
,18/08/2022,Expense Transaction (Bank Draft),Mary1791,TRADE SECRET,,EastX ****2310,-245,"924,824.30"
,18/08/2022,Expense,26,Royal,,Stock / Inventory Asset,"3,032.24","927,856.54"
,18/08/2022,Expense,NI149023,Big Yellow Self Storage,,-Split-,"1,132.88","928,989.42"
,19/08/2022,Expense,004/2022,Traditional Fine Engraving,5000 Eur: 1Eur @ £0.85398,Work in Progress,"4,407.27","933,396.69"
,19/08/2022,Expense Transaction (Bank Draft),Mary1794,Dirty laundry,,EastX ****2310,-115.2,"933,281.49"
,19/08/2022,Expense,1880,TimberLake Workshop,,-Split-,126,"933,407.49"
,20/08/2022,Expense,105,Coggan Simon Engraver,,Work in Progress,"12,000.00","945,407.49"
,20/08/2022,Expense,210801,Mayfair  Engineering,,-Split-,"3,606.00","949,013.49"
,23/08/2022,Expense,OP/I776248,GMK,,-Split-,665.64,"949,679.13"
,23/08/2022,Expense,OP/I776233,GMK,,-Split-,"2,123.28","951,802.41"
,23/08/2022,Expense,,Mark Remmant,,MARKETING/SELLING:Travel Expense,146.5,"951,948.91"
,23/08/2022,Expense,,A G Sinnett,,-Split-,156.34,"952,105.25"
,25/08/2022,Expense,6044,Beck Office,,Bookkeeping & Payroll,72,"952,177.25"
,25/08/2022,Expense,,Hambrusch,£1 = 1.15 EUR,-Split-,"1,391.28","953,568.53"
,25/08/2022,Expense,SI00729,Raytrade UK Ltd,,-Split-,"1,969.20","955,537.73"
,26/08/2022,Vendor Credit,,DHL,,MARKETING/SELLING:Postage and Delivery,-129.96,"955,407.77"
,26/08/2022,Expense Transaction (Bank Draft),Mary1798,A G Sinnett,,EastX ****2310,-156.34,"955,251.43"
,26/08/2022,Expense Transaction (Bank Draft),Mary1797,CA Bookkeeping Services Ltd,,EastX ****2310,"-1,056.00","954,195.43"
,26/08/2022,Expense Transaction (Bank Draft),Mary1799,Mark Remmant,,EastX ****2310,-146.5,"954,048.93"
,26/08/2022,Expense,103014,SRS Freight Ltd,,-Split-,700.35,"954,749.28"
,26/08/2022,Expense Transaction (Bank Draft),Mary1789,LAMBETH,,EastX ****2310,-73.28,"954,676.00"
,26/08/2022,Expense Transaction (Bank Draft),Mary1800,Ford,,EastX ****2310,-550.42,"954,125.58"
,26/08/2022,Expense,202102,Romain Lepinois,,Stock / Inventory Asset,"10,800.00","964,925.58"
,26/08/2022,Expense,61886,Manchester Automatic Machining,,-Split-,873.6,"965,799.18"
,26/08/2022,Expense Transaction (Bank Draft),Mary1802,Mayfair  Engineering,,EastX ****2310,"-7,287.96","958,511.22"
,27/08/2022,Expense Transaction (Bank Draft),Mary1805,Tweed Media,,EastX ****2310,"-4,800.00","953,711.22"
,27/08/2022,Expense Transaction (Bank Draft),Mary1790,Traditional Fine Engraving,,EastX ****2310,"-4,407.27","949,303.95"
,27/08/2022,Expense,61887,Manchester Automatic Machining,,Stock / Inventory Asset,288,"949,591.95"
,27/08/2022,Expense,AVI8754297,DHL,,-Split-,494.92,"950,086.87"
,27/08/2022,Expense,600619,Traditional English Guncases Ltd,,-Split-,239.4,"950,326.27"
,27/08/2022,Expense Transaction (Bank Draft),Mary1807,Propel Finance No 1,,EastX ****2310,-218.16,"950,108.11"
,28/08/2022,Expense,,Propel Finance No 1,,MARKETING/SELLING:Telephone Expense,218.16,"950,326.27"
,29/08/2022,Expense,35,BF&D LIMITED,,Stock / Inventory Asset,"1,950.00","952,276.27"
,29/08/2022,Expense,34,BF&D LIMITED,,Work in Progress,"5,000.00","957,276.27"
,30/08/2022,Expense,600623,Traditional English Guncases Ltd,,-Split-,216,"957,492.27"
,30/08/2022,Expense,600622,Traditional English Guncases Ltd,,Cost of sales,30,"957,522.27"
,31/08/2022,Expense Transaction (Bank Draft),1251,EtherLive LTD,,Business Card,-374.4,"957,147.87"
,31/08/2022,Expense Transaction (Bank Draft),1250,DHL,,Business Card,-70.32,"957,077.55"
,31/08/2022,Expense Transaction (Bank Draft),1217,BrandCo Branding Ltd,,Business Card,-419.28,"956,658.27"
,31/08/2022,Expense Transaction (Bank Draft),Mary1808,Aerial Direct,,EastX ****2310,-167.23,"956,491.04"
,31/08/2022,Expense,1751,A T Miles,,-Split-,520,"957,011.04"
,31/08/2022,Expense,,Northwood Group,,Shared cost,"2,636.50","959,647.54"
,31/08/2022,Expense,GD0821,Northwood USA,£1 = $1.35,MARKETING/SELLING:Consultants,"5,503.17","965,150.71"
,31/08/2022,Expense,,Northwood Group,,Shared cost,"1,015.00","966,165.71"
,31/08/2022,Expense,92054542,Abacus GP Ltd,,MARKETING/SELLING:Car Rental,274.17,"966,439.88"
,31/08/2022,Expense,,L & O Immobilien GMBH & Co KG,,ADMINISTRATION:Rent & Rates Expense,"10,666.11","977,105.99"
,31/08/2022,Expense,EH366337777,Parcelforce,,MARKETING/SELLING:Postage and Delivery,234.42,"977,340.41"
,1/9/2022,Expense Transaction (Bank Draft),Mary1804,CARS Classic Automotive Relocation Services,,EastX ****2310,-607.8,"976,732.61"
,1/9/2022,Expense,6710,Field Sports Publishing Inc,,MARKETING/SELLING,"2,939.52","979,672.13"
,1/9/2022,Expense Transaction (Bank Draft),9344,Field Sports Publishing Inc,,-Split-,,"979,672.13"
,1/9/2022,Expense Transaction (Bank Draft),Mary1810,Big Yellow Self Storage,,EastX ****2310,"-1,132.88","978,539.25"
,1/9/2022,Expense Transaction (Bank Draft),Mary1811,eon,,EastX ****2310,-15.62,"978,523.63"
,1/9/2022,Expense,LV904854,Derse Inc,£1 = $1.3,Storage,471.26,"978,994.89"
,1/9/2022,Expense,1649,Helston Gunsmiths,Expense dated 23 Mar 21,-Split-,20.4,"979,015.29"
,1/9/2022,Expense,15157172,Ford,,-Split-,565.42,"979,580.71"
,1/9/2022,Expense,168716095,Worldpay,,-Split-,203.63,"979,784.34"
,1/9/2022,Expense,18044,GWT Media,,ADMINISTRATION:Computer and Internet Expenses,45,"979,829.34"
,1/9/2022,Expense,,Jerome  Lannoue,,-Split-,"2,441.37","982,270.71"
,1/9/2022,Expense,,L & O Immobilien GMBH & Co KG,,ADMINISTRATION:Rent & Rates Expense,"10,666.11","992,936.82"
,1/9/2022,Expense,1188,Cooper Roberts,,Storage,540,"993,476.82"
,1/9/2022,Expense,414884,P Higgins & Sons Ltd,,-Split-,"1,800.00","995,276.82"
,1/9/2022,Expense,3111,Buck's Club Limited,,-Split-,241.25,"995,518.07"
,1/9/2022,Expense,424,Johnsons & Co Ltd,,-Split-,852,"996,370.07"
,1/9/2022,Expense,,Jamie,,MARKETING/SELLING:Petrol,471.91,"996,841.98"
,1/9/2022,Expense,22821,Hambrusch,£1 = 1.15 Eur,-Split-,"1,800.00","998,641.98"
,1/9/2022,Expense,5835,The Company of Gunmakers,,-Split-,100.56,"998,742.54"
,1/9/2022,Expense,1299,John Whitfield,,-Split-,840,"999,582.54"
,1/9/2022,Expense,2857,Buck's Club Limited,,ADMINISTRATION:Subscription,342.55,"999,925.09"
,1/9/2022,Expense,18104,GWT Media,,ADMINISTRATION:Computer and Internet Expenses,217.8,"1,000,142.89"
,1/9/2022,Expense,2021/0412,Rodl & Partner,,Accruals,"1,080.00","1,001,222.89"
,1/9/2022,Expense,2840,Buck's Club Limited,,ADMINISTRATION:Subscription,113.04,"1,001,335.93"
,1/9/2022,Expense Transaction (Bank Draft),9339,L & O Immobilien GMBH & Co KG,,EastX Bank,"-10,666.11","990,669.82"
,2/9/2022,Expense Transaction (Bank Draft),Mary1812,Redhead International,,EastX ****2310,"-15,743.33","974,926.49"
,2/9/2022,Expense Transaction (Bank Draft),Mary1814,London Barrel Maker,,EastX ****2310,"-3,240.00","971,686.49"
,2/9/2022,Expense Transaction (Bank Draft),Mary1813,London Barrel Maker,,EastX ****2310,"-3,240.00","968,446.49"
,2/9/2022,Expense Transaction (Bank Draft),Mary1815,Hoffmann Group,,EastX ****2310,-27.55,"968,418.94"
,2/9/2022,Expense,PD329,Natraj Publishers,,-Split-,260,"968,678.94"
,2/9/2022,Expense,44613,The Company of Gunmakers,,-Split-,136.56,"968,815.50"
,2/9/2022,Expense,,SRS Freight Ltd,,-Split-,"1,080.47","969,895.97"
,2/9/2022,Expense,463,London Barrel Maker,,Work in Progress,"3,240.00","973,135.97"
,2/9/2022,Expense,256,Merlin Unwin Books,,Stock / Inventory Asset,399.75,"973,535.72"
,3/9/2022,Expense Transaction (Bank Draft),1169,Raytrade UK Ltd,,Business Card,"-1,969.20","971,566.52"
,3/9/2022,Expense Transaction (Bank Draft),Mary1820,Natraj Publishers,,EastX ****2310,-260,"971,306.52"
,3/9/2022,Expense Transaction (Bank Draft),Mary1822,Argent Steel,,EastX ****2310,-392.4,"970,914.12"
,3/9/2022,Expense Transaction (Bank Draft),Mary1821,Triebel GMBH,,EastX ****2310,-281.41,"970,632.71"
,3/9/2022,Expense,14,Ray St Ledger & Sons,,-Split-,153.6,"970,786.31"
,3/9/2022,Expense,103028,SRS Freight Ltd,,-Split-,"3,377.28","974,163.59"
,3/9/2022,Expense,210901,Mayfair  Engineering,,-Split-,"3,608.40","977,771.99"
,3/9/2022,Expense,6754,CA Bookkeeping Services Ltd,,Bookkeeping & Payroll,844.8,"978,616.79"
,3/9/2022,Expense,,Triebel GMBH,,ADMINISTRATION:Exchange Rate cost,20.61,"978,637.40"
,3/9/2022,Expense,,Jerome  Lannoue,,ADMINISTRATION:Exchange Rate cost,15,"978,652.40"
,3/9/2022,Expense,CN0018180,Redhead International,,MARKETING/SELLING:Postage and Delivery,"1,962.56","980,614.96"
,5/9/2022,Expense,Ancient17,Dirty laundry,,ADMINISTRATION:Cleaning Supplies,48,"980,662.96"
,6/9/2022,Expense Transaction (Bank Draft),9196,Northwood USA,,Apple Account,"-5,629.00","975,033.96"
,6/9/2022,Expense,184,Fox & Co Bespokw Ltd,,-Split-,363,"975,396.96"
,6/9/2022,Expense,15,Ray St Ledger & Sons,,-Split-,736.8,"976,133.76"
,6/9/2022,Expense Transaction (Bank Draft),Mary1848,Merlin Unwin Books,,EastX ****2310,-399.75,"975,734.01"
,7/9/2022,Expense,103031,SRS Freight Ltd,,-Split-,831.47,"976,565.48"
,7/9/2022,Vendor Credit,NI149766,Big Yellow Self Storage,,Storage,-423.2,"976,142.28"
,7/9/2022,Expense,NI149765,Big Yellow Self Storage,,-Split-,573.2,"976,715.48"
,8/9/2022,Expense Transaction (Bank Draft),Mary1818,Tamas Szarka,,EastX ****2310,-24.5,"976,690.98"
,8/9/2022,Expense Transaction (Bank Draft),Mary1816,Traditional English Guncases Ltd,,EastX ****2310,"-24,481.75","952,209.23"
,8/9/2022,Expense,69805,ARC,,ADMINISTRATION:Office Supplies,72.04,"952,281.27"
,8/9/2022,Expense,5,Armurerie Du Bois De La Cote,,-Split-,"4,129.76","956,411.03"
,8/9/2022,Expense Transaction (Bank Draft),Mary1817,SRS Freight Ltd,,EastX ****2310,"-4,661.72","951,749.31"
,9/9/2022,Expense Transaction (Bank Draft),Mary1850,Jerome  Lannoue,,EastX ****2310,-801.07,"950,948.24"
,9/9/2022,Expense Transaction (Bank Draft),Mary1886,Field Sports Publishing Inc,,EastX ****2310,"-5,636.22","945,312.02"
,9/9/2022,Expense Transaction (Bank Draft),Mary1851,Jerome  Lannoue,,EastX ****2310,"-1,640.30","943,671.72"
,9/9/2022,Expense,SIN1805822,PPL PRS,,MARKETING/SELLING:Telephone Expense,253.34,"943,925.06"
,9/9/2022,Expense,1897,TimberLake Workshop,,-Split-,176.4,"944,101.46"
,9/9/2022,Expense,Sales Order,Wbc,,PreTransactions,"9,715.00","953,816.46"
,9/9/2022,Expense,80150271,LAMBETH,,ADMINISTRATION:Office Cleaning,160.65,"953,977.11"
,10/9/2022,Expense Transaction (Bank Draft),Mary1853,Peninsula,,EastX ****2310,-193.75,"953,783.36"
,10/9/2022,Expense Transaction (Bank Draft),Mary1852,Big Yellow Self Storage,,EastX ****2310,-150,"953,633.36"
,10/9/2022,Expense,U002439025,Peninsula,,MARKETING/SELLING:Consultants,193.75,"953,827.11"
,10/9/2022,Expense,13,Ray St Ledger & Sons,,-Split-,"1,686.90","955,514.01"
,10/9/2022,Expense,18,Ray St Ledger & Sons,,-Split-,"1,678.80","957,192.81"
,13/09/2022,Expense Transaction (Bank Draft),Mary1819,Negrini,,EastX ****2310,-406.8,"956,786.01"
,13/09/2022,Expense,259,Forest Italia,,Commission,"3,684.00","960,470.01"
,13/09/2022,Expense,2.11E+13,Northwood Group UK Vendor,,Cost of sales,"19,260.00","979,730.01"
,13/09/2022,Expense,1918,L W Butler,,-Split-,480,"980,210.01"
,13/09/2022,Expense,21232082,Swarovski Optik,,Work in Progress,"1,194.00","981,404.01"
,13/09/2022,Expense,,Peter Heath Glenser,,Cost of sales,"8,000.00","989,404.01"
,13/09/2022,Expense,,Negrini,,ADMINISTRATION:Exchange Rate cost,26.72,"989,430.73"
,14/09/2022,Expense Transaction (Bank Draft),9194,Gordy& Son,,Apple Account,"-63,262.00","926,168.73"
,14/09/2022,Expense,37470,Irons Brothers Ltd,,-Split-,"9,680.00","935,848.73"
,14/09/2022,Expense,103046,SRS Freight Ltd,,MARKETING/SELLING:Postage and Delivery,461.5,"936,310.23"
,14/09/2022,Expense,21232504,Swarovski Optik,,Cost of sales,163.5,"936,473.73"
,14/09/2022,Expense,1310,Talking Food,,MARKETING/SELLING:Advertising/Promotional,"3,000.00","939,473.73"
,15/09/2022,Expense Transaction (Bank Draft),9340,Abacus GP Ltd,,EastX Bank,-274.17,"939,199.56"
,15/09/2022,Expense Transaction (Bank Draft),Mary1856,Irons Brothers Ltd,,EastX ****2310,"-5,808.00","933,391.56"
,15/09/2022,Expense Transaction (Bank Draft),Mary1855,FOREMAN LOGISTICS,,EastX ****2310,"-1,296.00","932,095.56"
,15/09/2022,Expense Transaction (Bank Draft),Mary1857,Parcelforce,,EastX ****2310,-514.12,"931,581.44"
,15/09/2022,Expense,,Parcelforce,,MARKETING/SELLING:Postage and Delivery,612.74,"932,194.18"
,15/09/2022,Expense,,eon,,ADMINISTRATION:Utilities,6.36,"932,200.54"
,15/09/2022,Expense,3670,Tweed Media,,-Split-,"5,574.00","937,774.54"
,15/09/2022,Expense,OP/I1778613,GMK,,Cost of sales,13.27,"937,787.81"
,15/09/2022,Expense,1210,SonySports Press Limited,,MARKETING/SELLING:Marketing,"1,794.00","939,581.81"
,15/09/2022,Expense,427290,Aerial Direct,,MARKETING/SELLING:Telephone Expense,158.65,"939,740.46"
,16/09/2022,Expense Transaction (Bank Draft),Mary1830,Manchester Automatic Machining,,EastX ****2310,"-1,161.60","938,578.86"
,16/09/2022,Expense,210902,Mayfair  Engineering,,-Split-,"3,608.40","942,187.26"
,16/09/2022,Expense Transaction (Bank Draft),Mary1842,SRS Freight Ltd,,EastX ****2310,"-5,289.22","936,898.04"
,16/09/2022,Expense Transaction (Bank Draft),Mary1825,Rodl & Partner,,EastX ****2310,-133,"936,765.04"
,16/09/2022,Expense Transaction (Bank Draft),Mary1839,BF&D LIMITED,,EastX ****2310,"-6,950.00","929,815.04"
,16/09/2022,Expense Transaction (Bank Draft),Mary1824,Wbc,,EastX ****2310,"-6,047.22","923,767.82"
,16/09/2022,Expense Transaction (Bank Draft),Mary1841,A T Miles,,EastX ****2310,-520,"923,247.82"
,16/09/2022,Expense Transaction (Bank Draft),Mary1832,Knighthood International Security Ltd,,EastX ****2310,-150,"923,097.82"
,16/09/2022,Expense Transaction (Bank Draft),Mary1829,Mayfair  Engineering,,EastX ****2310,"-3,606.00","919,491.82"
,16/09/2022,Expense Transaction (Bank Draft),Mary1831,Laser Welding Services,,EastX ****2310,-159,"919,332.82"
,16/09/2022,Expense Transaction (Bank Draft),Mary1833,IPS Gunmaking Ltd,,EastX ****2310,"-3,014.00","916,318.82"
,16/09/2022,Expense Transaction (Bank Draft),Mary1836,Fox & Co Bespokw Ltd,,EastX ****2310,-549,"915,769.82"
,16/09/2022,Expense Transaction (Bank Draft),Mary1835,Giclee UK Ltd,,EastX ****2310,-588.5,"915,181.32"
,16/09/2022,Expense Transaction (Bank Draft),Mary1837,TimberLake Workshop,,EastX ****2310,-763.2,"914,418.12"
,16/09/2022,Expense Transaction (Bank Draft),Mary1860,LAMBETH,,EastX ****2310,-160.65,"914,257.47"
,16/09/2022,Expense Transaction (Bank Draft),Mary1823,Holzwelt Cases,,EastX ****2310,-343.06,"913,914.41"
,16/09/2022,Expense Transaction (Bank Draft),Mary1826,Rentokil,,EastX ****2310,-352.78,"913,561.63"
,16/09/2022,Expense Transaction (Bank Draft),Mary1840,Beck Office,,EastX ****2310,-72,"913,489.63"
,16/09/2022,Expense Transaction (Bank Draft),Mary1838,Edgar Brothers,,EastX ****2310,-666.02,"912,823.61"
,16/09/2022,Expense Transaction (Bank Draft),Mary1828,P Higgins & Sons Ltd,,EastX ****2310,"-1,800.00","911,023.61"
,16/09/2022,Expense Transaction (Bank Draft),Mary1827,Ray St Ledger & Sons,,EastX ****2310,-811.2,"910,212.41"
,16/09/2022,Expense Transaction (Bank Draft),Mary1859,Worldpay,,EastX ****2310,-204.04,"910,008.37"
,16/09/2022,Expense,,Holzwelt Cases,,ADMINISTRATION:Exchange Rate cost,21.59,"910,029.96"
,16/09/2022,Expense,H1A4693296,eon,,ADMINISTRATION:Utilities,281.38,"910,311.34"
,16/09/2022,Expense,210903,Mayfair  Engineering,,-Split-,"3,384.00","913,695.34"
,16/09/2022,Expense,H1A469328A,eon,,ADMINISTRATION:Utilities,84.48,"913,779.82"
,16/09/2022,Expense Transaction (Bank Draft),Mary1834,GMK,,EastX ****2310,"-2,788.92","910,990.90"
,17/09/2022,Expense Transaction (Bank Draft),Mary1863,Peter Heath Glenser,,EastX ****2310,"-8,000.00","902,990.90"
,17/09/2022,Expense Transaction (Bank Draft),9195,Northwood USA,,Apple Account,"-5,503.17","897,487.73"
,17/09/2022,Expense Transaction (Bank Draft),Mary1864,Hambrusch,,EastX ****2310,"-1,414.74","896,072.99"
,17/09/2022,Expense Transaction (Bank Draft),9342,Northwood Group,,EastX Bank,"-48,781.66","847,291.33"
,17/09/2022,Expense Transaction (Bank Draft),Mary1843,Northwood Group UK Vendor,,EastX ****2310,"-12,294.70","834,996.63"
,17/09/2022,Expense Transaction (Bank Draft),Mary1862,Cooper Roberts,,EastX ****2310,"-1,080.00","833,916.63"
,17/09/2022,Expense,NI150170,Big Yellow Self Storage,,-Split-,"1,132.88","835,049.51"
,17/09/2022,Expense,,Hambrusch,,ADMINISTRATION:Exchange Rate cost,23.46,"835,072.97"
,17/09/2022,Expense,2021-678,Dallas Safari Club,"$9,200 ",PreTransactions,"7,076.92","842,149.89"
,17/09/2022,Expense,8400057433,Northwood Group,,-Split-,"24,136.80","866,286.69"
,17/09/2022,Expense,,Northwood USA,£1 = $1.30,MARKETING/SELLING:Consultants,"5,629.00","871,915.69"
,17/09/2022,Expense,49,Jonathan Jamin,,Work in Progress,"1,480.00","873,395.69"
,17/09/2022,Expense Transaction (Bank Draft),Mary1865,John Whitfield,,EastX ****2310,-840,"872,555.69"
,19/09/2022,Expense,,Jerome  Lannoue,,-Split-,"2,716.22","875,271.91"
,20/09/2022,Expense,,LAMBETH,,MARKETING/SELLING:Misc,180,"875,451.91"
,20/09/2022,Expense,9063676180,Parcelforce,,MARKETING/SELLING:Postage and Delivery,362.99,"875,814.90"
,20/09/2022,Expense,OP/I778868,GMK,,Cost of sales,10.56,"875,825.46"
,21/09/2022,Expense Transaction (Bank Draft),88443298,Jerome  Lannoue,,EastX  Saver ****7829,"-1,573.52","874,251.94"
,21/09/2022,Expense Transaction (Bank Draft),88443297,Jerome  Lannoue,,EastX  Saver ****7829,"-1,142.70","873,109.24"
,21/09/2022,Expense,10019,Durable Fasteners Ltd,,Cost of sales,214.8,"873,324.04"
,21/09/2022,Expense,2814,Julian & Sons,,Storage,919.71,"874,243.75"
,21/09/2022,Expense,1703,Helston Gunsmiths,,Stock / Inventory Asset,33.6,"874,277.35"
,21/09/2022,Expense,600629,Traditional English Guncases Ltd,,Work in Progress,"1,800.00","876,077.35"
,21/09/2022,Expense,23002,Tony Maidment,,Work in Progress,"10,000.00","886,077.35"
,21/09/2022,Expense,600631,Traditional English Guncases Ltd,,-Split-,"2,400.00","888,477.35"
,21/09/2022,Expense,21233315,Swarovski Optik,,-Split-,"15,385.50","903,862.85"
,21/09/2022,Expense,600630,Traditional English Guncases Ltd,,Stock / Inventory Asset,"2,160.00","906,022.85"
,22/09/2022,Expense Transaction (Bank Draft),Mary1868,Tony Maidment,,EastX ****2310,"-10,000.00","896,022.85"
,22/09/2022,Expense,189,Fox & Co Bespokw Ltd,,-Split-,410.7,"896,433.55"
,22/09/2022,Expense,,A G Sinnett,,-Split-,155.82,"896,589.37"
,22/09/2022,Expense,34,Royal,,Storage,540,"897,129.37"
,22/09/2022,Expense,AN1435066,Redhead International,,MARKETING/SELLING:Postage and Delivery,50,"897,179.37"
,23/09/2022,Expense,516,ARC Ballistics Limited,,-Split-,"1,972.80","899,152.17"
,23/09/2022,Expense,10124,Durable Fasteners Ltd,,-Split-,301.7,"899,453.87"
,23/09/2022,Expense,1921,TimberLake Workshop,,-Split-,297.56,"899,751.43"
,24/09/2022,Expense,DVI103081,SRS Freight Ltd,,-Split-,372.43,"900,123.86"
,24/09/2022,Expense,103082,SRS Freight Ltd,,MARKETING/SELLING:Postage and Delivery,131.5,"900,255.36"
,24/09/2022,Expense,103078,SRS Freight Ltd,,MARKETING/SELLING:Postage and Delivery,327.08,"900,582.44"
,24/09/2022,Expense,AVI8825669,DHL,,MARKETING/SELLING:Postage and Delivery,117.91,"900,700.35"
,24/09/2022,Expense,53062,Knighthood International Security Ltd,,MARKETING/SELLING:Repair and maintenance,156,"900,856.35"
,25/09/2022,Expense,6097,Beck Office,,Bookkeeping & Payroll,72,"900,928.35"
,27/09/2022,Expense Transaction (Bank Draft),Mary1874,Redhead International,,EastX ****2310,"-4,547.00","896,381.35"
,27/09/2022,Expense Transaction (Bank Draft),Mary1875,Debbie Thomas,,EastX ****2310,-60,"896,321.35"
,27/09/2022,Expense Transaction (Bank Draft),Mary1880,Armurerie Du Bois De La Cote,,EastX ****2310,"-4,129.76","892,191.59"
,27/09/2022,Expense Transaction (Bank Draft),Mary1877,Propel Finance No 1,,EastX ****2310,-218.16,"891,973.43"
,27/09/2022,Expense Transaction (Bank Draft),Mary1876,DHL,,EastX ****2310,-117.91,"891,855.52"
,27/09/2022,Expense Transaction (Bank Draft),Mary1870,Helston Gunsmiths,,EastX ****2310,-54,"891,801.52"
,27/09/2022,Expense Transaction (Bank Draft),Mary1871,GWT Media,,EastX ****2310,-45,"891,756.52"
,27/09/2022,Expense Transaction (Bank Draft),Mary1878,Chubb Fire & Security Ltd,,EastX ****2310,-542.83,"891,213.69"
,27/09/2022,Expense Transaction (Bank Draft),Mary1872,Ford,,EastX ****2310,-565.42,"890,648.27"
,28/09/2022,Expense,C0018450,Redhead International,,MARKETING/SELLING:Postage and Delivery,"4,547.00","895,195.27"
,28/09/2022,Expense,201818,Debbie Thomas,,-Split-,60,"895,255.27"
,28/09/2022,Expense,,Hellmann Worlwide Logistics,,MARKETING/SELLING:Postage and Delivery,25,"895,280.27"
,28/09/2022,Expense,1928,TimberLake Workshop,,-Split-,285.6,"895,565.87"
,28/09/2022,Expense,,Propel Finance No 1,,MARKETING/SELLING:Telephone Expense,218.16,"895,784.03"
,29/09/2022,Expense,,Martin Levis Expenses,,MARKETING/SELLING:Travel Expense,80.95,"895,864.98"
,30/09/2022,Expense Transaction (Bank Draft),Mary1884,Buck's Club Limited,,EastX ****2310,-545.59,"895,319.39"
,30/09/2022,Expense Transaction (Bank Draft),Mary1883,Aerial Direct,,EastX ****2310,-158.65,"895,160.74"
,30/09/2022,Expense Transaction (Bank Draft),Mary1882,Tweed Media,,EastX ****2310,"-5,574.00","889,586.74"
,30/09/2022,Expense,72964,Harper Office,,PreTransactions,"1,200.00","890,786.74"
,30/09/2022,Expense,,Northwood Group,,Shared cost,"1,015.00","891,801.74"
,30/09/2022,Expense,8400060039,Northwood Group,,Shipping & Freight,243.68,"892,045.42"
,30/09/2022,Expense,,Northwood Group,,Shared cost,"2,636.50","894,681.92"
,30/09/2022,Expense,1754,A T Miles,,-Split-,500,"895,181.92"
,30/09/2022,Expense,,Northwood Group,,Accruals,"32,504.13","927,686.05"
,30/09/2022,Expense,3682,Tweed Media,,MARKETING/SELLING:Marketing,"1,848.00","929,534.05"
,30/09/2022,Expense,AVI8844824,DHL,,MARKETING/SELLING:Postage and Delivery,83.15,"929,617.20"
,1/10/2022,Expense Transaction (Bank Draft),Mary1923,eon,,EastX ****2310,-6.36,"929,610.84"
,1/10/2022,Vendor Credit,,Durable Fasteners Ltd,,Cost of sales,-214.8,"929,396.04"
,1/10/2022,Expense Transaction (Bank Draft),Mary1922,Buck's Club Limited,,EastX ****2310,-241.25,"929,154.79"
,1/10/2022,Expense Transaction (Bank Draft),Mary1887,Big Yellow Self Storage,,EastX ****2310,"-1,132.88","928,021.91"
,1/10/2022,Expense,1942,TimberLake Workshop,,-Split-,261.6,"928,283.51"
,1/10/2022,Expense,1240JRL,Laser Welding Services,,-Split-,"1,207.15","929,490.66"
,1/10/2022,Expense,,L & O Immobilien GMBH & Co KG,,ADMINISTRATION:Rent & Rates Expense,"10,666.11","940,156.77"
,1/10/2022,Expense,,Parcelforce,,MARKETING/SELLING:Postage and Delivery,96.79,"940,253.56"
,1/10/2022,Expense,600642,Traditional English Guncases Ltd,,Cost of sales,444,"940,697.56"
,1/10/2022,Expense,428430,Aerial Direct,,MARKETING/SELLING:Telephone Expense,159.7,"940,857.26"
,1/10/2022,Expense,600643,Traditional English Guncases Ltd,,-Split-,"2,160.00","943,017.26"
,1/10/2022,Expense,16870,SAS Liogier- Allary,,Materials & Tools,265.16,"943,282.42"
,1/10/2022,Expense,18275,GWT Media,,ADMINISTRATION:Computer and Internet Expenses,232.2,"943,514.62"
,1/10/2022,Expense,36,BF&D LIMITED,,Work in Progress,"2,500.00","946,014.62"
,1/10/2022,Expense,80149380,LAMBETH,,ADMINISTRATION:Office Cleaning,142.62,"946,157.24"
,1/10/2022,Expense,467,Johnsons & Co Ltd,,Accruals,468,"946,625.24"
,1/10/2022,Expense,3453,ElS And Co (Pty) Ltd,,-Split-,"1,056.00","947,681.24"
,1/10/2022,Expense,173240209,Worldpay,,-Split-,"2,357.34","950,038.58"
,1/10/2022,Expense,1784,TimberLake Workshop,,-Split-,93.6,"950,132.18"
,1/10/2022,Expense,1241JRL,Laser Welding Services,,-Split-,129.18,"950,261.36"
,1/10/2022,Expense,8400057314,Northwood GMBH,,-Split-,"9,373.00","959,634.36"
,1/10/2022,Expense,RE0134,Holzwelt Cases,,Stock / Inventory Asset,217.4,"959,851.76"
,1/10/2022,Expense,Proforma,Everarms Engineering Ltd,,-Split-,"40,161.72","1,000,013.48"
,1/10/2022,Expense,8892753,Chubb Fire & Security Ltd,,MARKETING/SELLING:Repair and maintenance,324,"1,000,337.48"
,1/10/2022,Expense,1485,TimberLake Workshop,,-Split-,232.8,"1,000,570.28"
,1/10/2022,Expense,1651,Air Source Climate Control Limited,,MARKETING/SELLING:Repair and maintenance,525,"1,001,095.28"
,1/10/2022,Expense,006/2022,Traditional Fine Engraving,,Work in Progress,"6,525.80","1,007,621.08"
,1/10/2022,Expense,600634,Traditional English Guncases Ltd,,-Split-,"8,640.00","1,016,261.08"
,1/10/2022,Expense,,Buck's Club Limited,I have requested the copy of Receipt,ADMINISTRATION:Subscription,90,"1,016,351.08"
,1/10/2022,Expense,938693,Lothar Walther,,-Split-,"2,974.41","1,019,325.49"
,1/10/2022,Expense,,Ford,,MARKETING/SELLING:Car Rental,550.42,"1,019,875.91"
,1/10/2022,Expense,713,Parthoens,,Research and Development,"8,220.44","1,028,096.35"
,1/10/2022,Expense,600641,Traditional English Guncases Ltd,,-Split-,"2,844.00","1,030,940.35"
,1/10/2022,Expense,76164,Kerast,,-Split-,504,"1,031,444.35"
,1/10/2022,Expense,1621,TimberLake Workshop,,-Split-,111.6,"1,031,555.95"
,1/10/2022,Expense,2.10E+13,Riflecraft Limited,,-Split-,59.34,"1,031,615.29"
,1/10/2022,Expense Transaction (Bank Draft),Mary1912,Durable Fasteners Ltd,,-Split-,,"1,031,615.29"
,4/10/2022,Expense Transaction (Bank Draft),Mary1847,Martin Levis Expenses,,EastX ****2310,-80.95,"1,031,534.34"
,4/10/2022,Expense,414889,P Higgins & Sons Ltd,,Work in Progress,"2,400.00","1,033,934.34"
,4/10/2022,Expense Transaction (Bank Draft),Mary1846,CA Bookkeeping Services Ltd,,EastX ****2310,-844.8,"1,033,089.54"
,5/10/2022,Expense,6030435,Schmidt Bender,,Work in Progress,"1,195.40","1,034,284.94"
,6/10/2022,Expense,JEK/2101,James E Kulczyk,,Work in Progress,"1,050.00","1,035,334.94"
,6/10/2022,Expense,35,Royal,,Accruals,"41,980.00","1,077,314.94"
,6/10/2022,Expense,70594,ARC,,ADMINISTRATION:Office Supplies,45.54,"1,077,360.48"
,6/10/2022,Expense,103107,SRS Freight Ltd,,MARKETING/SELLING:Postage and Delivery,"1,154.68","1,078,515.16"
,7/10/2022,Expense,44669,The Company of Gunmakers,,-Split-,792.9,"1,079,308.06"
,7/10/2022,Expense,2021-A-2286,Negrini,,Cost of sales,"1,147.82","1,080,455.88"
,7/10/2022,Expense,103109,SRS Freight Ltd,,MARKETING/SELLING:Postage and Delivery,777,"1,081,232.88"
,7/10/2022,Expense,Ancient18,Dirty laundry,,ADMINISTRATION:Cleaning Supplies,24,"1,081,256.88"
,8/10/2022,Expense,6887,CA Bookkeeping Services Ltd,,Bookkeeping & Payroll,844.8,"1,082,101.68"
,11/10/2022,Expense Transaction (Bank Draft),9197,Forest Italia,,Apple Account,-748.3,"1,081,353.38"
,11/10/2022,Expense,1252JRL,Laser Welding Services,,-Split-,194.22,"1,081,547.60"
,11/10/2022,Expense,6734,Field Sports Publishing Inc,,MARKETING/SELLING,"2,814.80","1,084,362.40"
,11/10/2022,Expense,44676,The Company of Gunmakers,,Cost of sales,53.7,"1,084,416.10"
,11/10/2022,Expense,1406,Broadbent Leather goods,,-Split-,435,"1,084,851.10"
,11/10/2022,Expense,349,IPS Gunmaking Ltd,,Work in Progress,"3,337.00","1,088,188.10"
,12/10/2022,Expense Transaction (Bank Draft),Mary1929,Parthoens,,EastX ****2310,"-8,220.44","1,079,967.66"
,12/10/2022,Expense,1952,TimberLake Workshop,,-Split-,99.6,"1,080,067.26"
,12/10/2022,Expense Transaction (Bank Draft),Mary1894,Knighthood International Security Ltd,,EastX ****2310,-156,"1,079,911.26"
,12/10/2022,Expense Transaction (Bank Draft),Mary1909,Jonathan Jamin,,EastX ****2310,"-1,494.52","1,078,416.74"
,12/10/2022,Expense Transaction (Bank Draft),Mary1895,Jamie,,EastX ****2310,-471.91,"1,077,944.83"
,12/10/2022,Expense Transaction (Bank Draft),Mary1901,Beck Office,,EastX ****2310,-72,"1,077,872.83"
,12/10/2022,Expense Transaction (Bank Draft),Mary1888,Durable Fasteners Ltd,,EastX ****2310,-516.5,"1,077,356.33"
,12/10/2022,Expense Transaction (Bank Draft),Mary1889,Ray St Ledger & Sons,,EastX ****2310,"-4,256.10","1,073,100.23"
,12/10/2022,Expense Transaction (Bank Draft),Mary1898,Dirty laundry,,EastX ****2310,-72,"1,073,028.23"
,12/10/2022,Expense Transaction (Bank Draft),Mary1902,ARC,,EastX ****2310,-117.58,"1,072,910.65"
,12/10/2022,Expense Transaction (Bank Draft),Mary1897,TimberLake Workshop,,EastX ****2310,"-1,021.16","1,071,889.49"
,12/10/2022,Expense Transaction (Bank Draft),Mary1907,DHL,,EastX ****2310,"-1,668.00","1,070,221.49"
,12/10/2022,Expense Transaction (Bank Draft),Mary1891,LAMBETH,,EastX ****2310,-142.62,"1,070,078.87"
,12/10/2022,Expense Transaction (Bank Draft),Mary1905,Mayfair  Engineering,,EastX ****2310,"-10,600.00","1,059,478.87"
,12/10/2022,Expense Transaction (Bank Draft),Mary1904,A G Sinnett,,EastX ****2310,-155.82,"1,059,323.05"
,12/10/2022,Expense Transaction (Bank Draft),9347,L & O Immobilien GMBH & Co KG,,EastX Bank,"-10,666.11","1,048,656.94"
,12/10/2022,Expense Transaction (Bank Draft),Mary1908,CTS (GB) Limited,,EastX ****2310,"-1,155.00","1,047,501.94"
,12/10/2022,Expense Transaction (Bank Draft),Mary1899,CA Bookkeeping Services Ltd,,EastX ****2310,-844.8,"1,046,657.14"
,12/10/2022,Expense Transaction (Bank Draft),Mary1910,Hambrusch,,EastX ****2310,"-1,817.53","1,044,839.61"
,12/10/2022,Expense Transaction (Bank Draft),Mary1903,A T Miles,,EastX ****2310,-500,"1,044,339.61"
,12/10/2022,Expense Transaction (Bank Draft),Mary1890,P Higgins & Sons Ltd,,EastX ****2310,"-2,400.00","1,041,939.61"
,12/10/2022,Expense Transaction (Bank Draft),Mary1930,Lothar Walther,,EastX ****2310,"-2,974.41","1,038,965.20"
,12/10/2022,Expense Transaction (Bank Draft),Mary1900,Broadbent Leather goods,,EastX ****2310,-435,"1,038,530.20"
,12/10/2022,Expense Transaction (Bank Draft),Mary1906,Redhead International,,EastX ****2310,"-2,012.56","1,036,517.64"
,12/10/2022,Expense Transaction (Bank Draft),Mary1893,L W Butler,,EastX ****2310,-480,"1,036,037.64"
,12/10/2022,Expense,,Hambrusch,,ADMINISTRATION:Exchange Rate cost,17.53,"1,036,055.17"
,12/10/2022,Expense,,Jonathan Jamin,,ADMINISTRATION:Exchange Rate cost,14.52,"1,036,069.69"
,12/10/2022,Expense,62021,Manchester Automatic Machining,,-Split-,309.6,"1,036,379.29"
,12/10/2022,Expense,31,Ray St Ledger & Sons,,-Split-,520.8,"1,036,900.09"
,12/10/2022,Expense,,Mark Remmant,,MARKETING/SELLING:Travel Expense,293,"1,037,193.09"
,12/10/2022,Expense Transaction (Bank Draft),Mary1928,Traditional English Guncases Ltd,,EastX ****2310,"-6,360.00","1,030,833.09"
,13/10/2022,Expense Transaction (Bank Draft),Mary1916,Phil Coggan,,EastX ****2310,"-10,000.00","1,020,833.09"
,13/10/2022,Expense,80151146,LAMBETH,,ADMINISTRATION:Office Cleaning,160.25,"1,020,993.34"
,13/10/2022,Expense Transaction (Bank Draft),Mary1911,Fox & Co Bespokw Ltd,,EastX ****2310,-410.7,"1,020,582.64"
,13/10/2022,Expense Transaction (Bank Draft),Mary1912,Swarovski Optik,,EastX ****2310,"-1,194.00","1,019,388.64"
,13/10/2022,Expense Transaction (Bank Draft),9348,eon,,EastX Bank,-84.48,"1,019,304.16"
,13/10/2022,Expense Transaction (Bank Draft),Mary1915,Coggan Simon Engraver,,EastX ****2310,"-5,000.00","1,014,304.16"
,13/10/2022,Expense Transaction (Bank Draft),Mary1920,Laser Welding Services,,EastX ****2310,-194.22,"1,014,109.94"
,13/10/2022,Expense Transaction (Bank Draft),9349,eon,,EastX Bank,-281.38,"1,013,828.56"
,13/10/2022,Expense Transaction (Bank Draft),Mary1918,Traditional Fine Engraving,,EastX ****2310,"-6,525.80","1,007,302.76"
,13/10/2022,Expense Transaction (Bank Draft),Mary1917,BF&D LIMITED,,EastX ****2310,"-2,500.00","1,004,802.76"
,13/10/2022,Expense Transaction (Bank Draft),Mary1914,SRS Freight Ltd,,EastX ****2310,"-3,224.00","1,001,578.76"
,13/10/2022,Expense Transaction (Bank Draft),Mary1913,Rodl & Partner,,EastX ****2310,"-1,080.00","1,000,498.76"
,13/10/2022,Expense,OP/I781025,GMK,,-Split-,"1,181.40","1,001,680.16"
,13/10/2022,Expense,282,Phil Coggan,,Work in Progress,"8,160.00","1,009,840.16"
,13/10/2022,Expense Transaction (Bank Draft),Mary1919,Laser Welding Services,,EastX ****2310,"-1,336.33","1,008,503.83"
,14/10/2022,Expense Transaction (Bank Draft),9350,Northwood Group,,EastX Bank,"-53,912.80","954,591.03"
,14/10/2022,Expense Transaction (Bank Draft),Mary1935,ARC Ballistics Limited,,EastX ****2310,"-1,972.80","952,618.23"
,14/10/2022,Expense Transaction (Bank Draft),Mary1938,Julian & Sons,,EastX ****2310,-919.71,"951,698.52"
,14/10/2022,Expense Transaction (Bank Draft),Mary1937,GMK,,EastX ****2310,-23.83,"951,674.69"
,14/10/2022,Expense,2021056,Ian Clarke,,-Split-,464.28,"952,138.97"
,14/10/2022,Expense Transaction (Bank Draft),Mary1933,Cooper Roberts,,EastX ****2310,"-4,740.00","947,398.97"
,14/10/2022,Expense Transaction (Bank Draft),Mary1932,Wbc,,EastX ****2310,"-6,280.98","941,117.99"
,14/10/2022,Expense Transaction (Bank Draft),Mary1934,Swarovski Optik,,EastX ****2310,-163.5,"940,954.49"
,14/10/2022,Expense,,Jerome  Lannoue,,MARKETING/SELLING:Travel Expense,"3,336.87","944,291.36"
,14/10/2022,Expense Transaction (Bank Draft),Mary1936,Harper Office,,EastX ****2310,"-1,200.00","943,091.36"
,15/10/2022,Expense Transaction (Bank Draft),Mary1942,Wbc,,-Split-,,"943,091.36"
,15/10/2022,Expense,,SASU BYG France,,Cost of sales,"1,414.42","944,505.78"
,15/10/2022,Expense,H1A5DD2907,eon,,ADMINISTRATION:Utilities,253.55,"944,759.33"
,15/10/2022,Vendor Credit,CN665128,Wbc,Please see sales order from 9 Sep 21 and Receipt attached 665128,PreTransactions,-376.08,"944,383.25"
,16/10/2022,Expense,109,Coggan Simon Engraver,,Work in Progress,"1,440.00","945,823.25"
,16/10/2022,Expense,1286,SonySports Press Limited,,MARKETING/SELLING:Marketing,900,"946,723.25"
,16/10/2022,Expense,,Teague Precision Chokes Ltd,,-Split-,"1,129.13","947,852.38"
,16/10/2022,Expense,108,Coggan Simon Engraver,,Work in Progress,"36,000.00","983,852.38"
,16/10/2022,Expense,,Steve Kelly,,-Split-,"4,060.00","987,912.38"
,17/10/2022,Expense,H1A5F11C4B,eon,,ADMINISTRATION:Utilities,45.83,"987,958.21"
,18/10/2022,Expense Transaction (Bank Draft),Mary1941,Traditional English Guncases Ltd,,EastX ****2310,"-11,928.00","976,030.21"
,18/10/2022,Expense Transaction (Bank Draft),Mary1944,T & D O'Neill,,EastX ****2310,-450,"975,580.21"
,18/10/2022,Expense Transaction (Bank Draft),Mary1940,SRS Freight Ltd,,EastX ****2310,-0.19,"975,580.02"
,18/10/2022,Expense Transaction (Bank Draft),Mary1945,T & D O'Neill,,EastX ****2310,-410,"975,170.02"
,18/10/2022,Expense Transaction (Bank Draft),Mary1948,Lancashire Timber,,EastX ****2310,-338,"974,832.02"
,18/10/2022,Expense,15.2,T & D O'Neill,,Cost of sales,860,"975,692.02"
,18/10/2022,Expense,2021/1812,Rodl & Partner,,Accruals,"5,040.00","980,732.02"
,18/10/2022,Expense,1303,John Whitfield,,-Split-,959,"981,691.02"
,18/10/2022,Expense,8,Armurerie Du Bois De La Cote,,-Split-,"7,043.45","988,734.47"
,18/10/2022,Expense,44689,The Company of Gunmakers,,Work in Progress,80.56,"988,815.03"
,18/10/2022,Expense,38,BF&D LIMITED,,-Split-,"15,000.00","1,003,815.03"
,18/10/2022,Expense,211001,Mayfair  Engineering,,-Split-,"3,608.40","1,007,423.43"
,18/10/2022,Expense,,Geoffrey,,MARKETING/SELLING:Travel Expense,44.02,"1,007,467.45"
,18/10/2022,Expense,1,Lancashire Timber,,-Split-,338,"1,007,805.45"
,18/10/2022,Expense,NI151270,Big Yellow Self Storage,,-Split-,"1,132.88","1,008,938.33"
,18/10/2022,Expense,,Tamas Szarka,,MARKETING/SELLING:Travel Expense,71.06,"1,009,009.39"
,18/10/2022,Expense,1923,L W Butler,,Work in Progress,"8,022.00","1,017,031.39"
,19/10/2022,Expense Transaction (Bank Draft),Mary1951,Jerome  Lannoue,,EastX ****2310,"-3,336.87","1,013,694.52"
,19/10/2022,Expense Transaction (Bank Draft),Mary1949,Tamas Szarka,,EastX ****2310,-71.06,"1,013,623.46"
,19/10/2022,Cash Deposit,,J P Sauer & Sohn Gmbh,Refund CN,EastX Bank,321.74,"1,013,945.20"
,19/10/2022,Expense,37,BF&D LIMITED,,Work in Progress,"2,500.00","1,016,445.20"
,19/10/2022,Expense Transaction (Bank Draft),Mary1954,Parcelforce,,EastX ****2310,-362.99,"1,016,082.21"
,19/10/2022,Expense,3688,Tweed Media,,-Split-,"5,223.22","1,021,305.43"
,19/10/2022,Expense,8400064087,Northwood Group,,-Split-,"47,728.62","1,069,034.05"
,19/10/2022,Expense Transaction (Bank Draft),9354,J P Sauer & Sohn Gmbh,,-Split-,,"1,069,034.05"
,20/10/2022,Expense,103146,SRS Freight Ltd,,MARKETING/SELLING:Postage and Delivery,"1,996.50","1,071,030.55"
,20/10/2022,Expense,,Tamas Szarka,,MARKETING/SELLING:Travel Expense,84.26,"1,071,114.81"
,20/10/2022,Expense,2021/207,Northwood Group,,Gross Pay,"11,547.56","1,082,662.37"
,20/10/2022,Expense,44682,The Company of Gunmakers,,Work in Progress,80.56,"1,082,742.93"
,20/10/2022,Expense,56,The Gun & Allied Trade Benevolent Society,,MARKETING/SELLING:Staff welfare and Training,380,"1,083,122.93"
,21/10/2022,Expense,996,T F Wood & Son,,-Split-,"5,490.00","1,088,612.93"
,21/10/2022,Expense,3643,ElS And Co (Pty) Ltd,,Stock / Inventory Asset,68,"1,088,680.93"
,21/10/2022,Expense,CN0021261,Redhead International,,MARKETING/SELLING:Postage and Delivery,"8,983.17","1,097,664.10"
,21/10/2022,Expense,3642,ElS And Co (Pty) Ltd,,Stock / Inventory Asset,"1,560.00","1,099,224.10"
,21/10/2022,Expense,3641,ElS And Co (Pty) Ltd,,-Split-,"1,152.00","1,100,376.10"
,21/10/2022,Expense,103149,SRS Freight Ltd,,Cost of sales,"3,592.18","1,103,968.28"
,22/10/2022,Expense Transaction (Bank Draft),Mary1943,SonySports Press Limited,,-Split-,,"1,103,968.28"
,22/10/2022,Expense,73167,Harper Office,,ADMINISTRATION:Office Supplies,289.87,"1,104,258.15"
,22/10/2022,Expense,211104,Mayfair  Engineering,,-Split-,"9,936.00","1,114,194.15"
,22/10/2022,Vendor Credit,CN 1087,SonySports Press Limited,,MARKETING/SELLING:Advertising/Promotional,"-1,794.00","1,112,400.15"
,24/10/2022,Expense,1,Sam Faraway,,-Split-,900,"1,113,300.15"
,25/10/2022,Expense Transaction (Bank Draft),Mary1943,GWT Media,,EastX ****2310,-450,"1,112,850.15"
,25/10/2022,Expense,1304,John Whitfield,,-Split-,420,"1,113,270.15"
,25/10/2022,Expense,,Aqueous,,ADMINISTRATION:Office Cleaning,115,"1,113,385.15"
,25/10/2022,Expense,2021/49,Magic Safari Lodges,,MARKETING/SELLING:Advertising/Promotional,"3,043.45","1,116,428.60"
,25/10/2022,Expense,,Jamie,,MARKETING/SELLING:Petrol,363.11,"1,116,791.71"
,25/10/2022,Expense,6143,Beck Office,,Bookkeeping & Payroll,72,"1,116,863.71"
,25/10/2022,Expense,AN1449241,Redhead International,,MARKETING/SELLING:Postage and Delivery,50,"1,116,913.71"
,25/10/2022,Expense,1965,TimberLake Workshop,,-Split-,162,"1,117,075.71"
,25/10/2022,Expense,149,I. S. SWEETMAN GUN & RIFLE MAKERS LTD,,-Split-,"2,230.00","1,119,305.71"
,25/10/2022,Expense,,Mark Remmant,,MARKETING/SELLING:Travel Expense,175.8,"1,119,481.51"
,26/10/2022,Expense Transaction (Bank Draft),Mary1961,Ford,,EastX ****2310,-550.42,"1,118,931.09"
,26/10/2022,Expense,AVI8903861,DHL,,MARKETING/SELLING:Postage and Delivery,209.23,"1,119,140.32"
,26/10/2022,Expense,38,Royal,,Storage,540,"1,119,680.32"
,27/10/2022,Expense,AVI8908411,DHL,,MARKETING/SELLING:Postage and Delivery,156.49,"1,119,836.81"
,27/10/2022,Expense Transaction (Bank Draft),Mary1946,Geoffrey,,EastX ****2310,-44.02,"1,119,792.79"
,28/10/2022,Expense Transaction (Bank Draft),Mary1963,Ian Clarke,,EastX ****2310,-464.28,"1,119,328.51"
,28/10/2022,Expense Transaction (Bank Draft),Mary1962,Everarms Engineering Ltd,,EastX ****2310,"-40,161.72","1,079,166.79"
,28/10/2022,Expense Transaction (Bank Draft),Mary1965,Worldpay,,EastX ****2310,"-2,447.34","1,076,719.45"
,28/10/2022,Expense,103194,SRS Freight Ltd,,PreTransactions,"2,623.10","1,079,342.55"
,28/10/2022,Expense,17090,Aform Tooling Limited,,-Split-,972,"1,080,314.55"
,28/10/2022,Expense,,Marc Newton Expenses,,-Split-,150,"1,080,464.55"
,28/10/2022,Expense,,Mary Gil,,-Split-,847.54,"1,081,312.09"
,28/10/2022,Expense,AVI8911886,DHL,,MARKETING/SELLING:Postage and Delivery,"1,028.97","1,082,341.06"
,28/10/2022,Expense,,Worldpay,,ADMINISTRATION:Bank & card charges,90,"1,082,431.06"
,29/10/2022,Expense Transaction (Bank Draft),Mary1969,Jamie,,EastX ****2310,-363.11,"1,082,067.95"
,29/10/2022,Expense Transaction (Bank Draft),Mary1971,Marc Newton Expenses,,EastX ****2310,-150,"1,081,917.95"
,29/10/2022,Expense Transaction (Bank Draft),Mary1957,Aqueous,,EastX ****2310,-115,"1,081,802.95"
,29/10/2022,Expense Transaction (Bank Draft),Mary1968,Mary Gil,,EastX ****2310,-847.54,"1,080,955.41"
,29/10/2022,Expense Transaction (Bank Draft),Mary1966,Mark Remmant,,EastX ****2310,-468.8,"1,080,486.61"
,29/10/2022,Expense,,Propel Finance No 1,,MARKETING/SELLING:Telephone Expense,218.16,"1,080,704.77"
,29/10/2022,Expense Transaction (Bank Draft),Mary1972,Aerial Direct,,EastX ****2310,-159.7,"1,080,545.07"
,29/10/2022,Expense Transaction (Bank Draft),Mary1970,Tamas Szarka,,EastX ****2310,-84.26,"1,080,460.81"
,29/10/2022,Expense,44716,The Company of Gunmakers,,-Split-,89.4,"1,080,550.21"
,29/10/2022,Expense,,Northwood USA,£1 = $1.35,MARKETING/SELLING:Consultants,"7,749.77","1,088,299.98"
,29/10/2022,Expense Transaction (Bank Draft),Mary1967,Tweed Media,,EastX ****2310,"-5,223.22","1,083,076.76"
,30/10/2022,Expense Transaction (Bank Draft),9198,Northwood USA,,Apple Account,"-7,749.77","1,075,326.99"
,30/10/2022,Expense,,Northwood Group,,Shared cost,"2,636.50","1,077,963.49"
,30/10/2022,Expense,,Northwood Group,,Shared cost,"1,015.00","1,078,978.49"
,30/10/2022,Expense Transaction (Bank Draft),1336,Parcelforce,,Business Card,-234.42,"1,078,744.07"
,31/10/2022,Expense Transaction (Bank Draft),1392,LAMBETH,,Business Card,-180,"1,078,564.07"
,31/10/2022,Expense Transaction (Bank Draft),1393,Parcelforce,,Business Card,-612.74,"1,077,951.33"
,31/10/2022,Expense,6307,Smoothly Driven Logistics Ltd,,PreTransactions,"4,560.00","1,082,511.33"
,31/10/2022,Expense,,Lambeth borough Council,,ADMINISTRATION:Rates,"1,297.00","1,083,808.33"
,31/10/2022,Expense,,Parcelforce,,MARKETING/SELLING:Postage and Delivery,417.33,"1,084,225.66"
,31/10/2022,Expense Transaction (Bank Draft),1385,PPL PRS,,Business Card,-253.34,"1,083,972.32"
,1/11/2022,Expense Transaction (Bank Draft),Mary2011,ElS And Co (Pty) Ltd,,EastX ****2310,"-3,874.50","1,080,097.82"
,1/11/2022,Expense,2.11E+13,Northwood Group UK Vendor,,Cost of sales,62.4,"1,080,160.22"
,1/11/2022,Expense,211002,Mayfair  Engineering,,-Split-,"3,384.00","1,083,544.22"
,1/11/2022,Expense,1206,Cooper Roberts,,Storage,540,"1,084,084.22"
,1/11/2022,Expense,1198,Cooper Roberts,,Storage,540,"1,084,624.22"
,1/11/2022,Expense,38,Ray St Ledger & Sons,,-Split-,90,"1,084,714.22"
,1/11/2022,Expense,177971477,Worldpay,,-Split-,"2,390.29","1,087,104.51"
,1/11/2022,Expense,201819,Debbie Thomas,,-Split-,685,"1,087,789.51"
,1/11/2022,Expense,18545,GWT Media,,ADMINISTRATION:Computer and Internet Expenses,226.2,"1,088,015.71"
,1/11/2022,Expense,16,Scott Wood,,Work in Progress,"2,800.00","1,090,815.71"
,1/11/2022,Expense,15448883,Ford,,MARKETING/SELLING:Car Rental,550.42,"1,091,366.13"
,1/11/2022,Expense,,The Shikar Club,,MARKETING/SELLING:Marketing,300,"1,091,666.13"
,1/11/2022,Expense,109647,C J Bridges,,-Split-,"1,050.00","1,092,716.13"
,1/11/2022,Expense,20847,TMC Ltd,,PreTransactions,"57,742.80","1,150,458.93"
,1/11/2022,Expense,PBkk 20-39,"Le Arms, LLC",,Commission,"2,810.00","1,153,268.93"
,1/11/2022,Expense,173335,Redwood InnoTaxions,,-Split-,70.97,"1,153,339.90"
,1/11/2022,Expense,2552,Arms Restoration Services,,-Split-,"3,996.00","1,157,335.90"
,1/11/2022,Expense,2553,Arms Restoration Services,,-Split-,"1,248.00","1,158,583.90"
,1/11/2022,Expense,429585,Aerial Direct,,MARKETING/SELLING:Telephone Expense,158.92,"1,158,742.82"
,1/11/2022,Expense,13986,The Courteney Boot Company,,-Split-,"8,786.33","1,167,529.15"
,1/11/2022,Expense,2021/001,Northwood Group SAS,,Gross Pay,"11,547.56","1,179,076.71"
,1/11/2022,Expense,198,Fox & Co Bespokw Ltd,,-Split-,228,"1,179,304.71"
,1/11/2022,Expense,600673,Traditional English Guncases Ltd,,Cost of sales,"1,800.00","1,181,104.71"
,1/11/2022,Expense Transaction (Bank Draft),9358,L & O Immobilien GMBH & Co KG,,EastX Bank,"-10,666.11","1,170,438.60"
,1/11/2022,Expense Transaction (Bank Draft),Mary2019,SNT Adventure Brands LLC,,EastX ****2310,-648.78,"1,169,789.82"
,2/11/2022,Expense,479,Stable Events Ltd,,MARKETING/SELLING:Marketing,"1,668.00","1,171,457.82"
,2/11/2022,Expense,1896,John Dickson & Son Ltd,,Cost of sales,606,"1,172,063.82"
,2/11/2022,Expense Transaction (Bank Draft),Mary1974,Big Yellow Self Storage,,EastX ****2310,"-1,132.88","1,170,930.94"
,2/11/2022,Expense Transaction (Bank Draft),Mary1973,Negrini,,EastX ****2310,"-1,147.82","1,169,783.12"
,2/11/2022,Expense Transaction (Bank Draft),9356,Royal,,EastX Bank,"-46,092.24","1,123,690.88"
,2/11/2022,Expense Transaction (Bank Draft),9357,eon,,EastX Bank,-253.55,"1,123,437.33"
,2/11/2022,Expense Transaction (Bank Draft),Mary2004,The Shikar Club,,EastX ****2310,-300,"1,123,137.33"
,4/11/2022,Expense,44,Ray St Ledger & Sons,,-Split-,937.2,"1,124,074.53"
,4/11/2022,Expense,10070,SNT Adventure Brands LLC,,Stock / Inventory Asset,648.78,"1,124,723.31"
,4/11/2022,Expense,,A G Sinnett,,-Split-,284.14,"1,125,007.45"
,4/11/2022,Expense,1932,Reiss Edwards Limited,,MARKETING/SELLING:Professional Fees,"1,800.00","1,126,807.45"
,4/11/2022,Expense,Ancient19,Dirty laundry,,ADMINISTRATION:Cleaning Supplies,48,"1,126,855.45"
,4/11/2022,Expense,71370,ARC,,ADMINISTRATION:Office Supplies,60.62,"1,126,916.07"
,4/11/2022,Expense,21567761,Rentokil,,MARKETING/SELLING:Repair and maintenance,352.78,"1,127,268.85"
,4/11/2022,Expense,,Parcelforce,,MARKETING/SELLING:Postage and Delivery,411.93,"1,127,680.78"
,5/11/2022,Expense,6993,CA Bookkeeping Services Ltd,,Bookkeeping & Payroll,"1,056.00","1,128,736.78"
,5/11/2022,Expense,2021-017677,Recknagel,£1 = 1.15 EUR,-Split-,227.65,"1,128,964.43"
,8/11/2022,Expense Transaction (Bank Draft),Mary2020,C J Bridges,,EastX ****2310,"-1,050.00","1,127,914.43"
,8/11/2022,Expense,34277,Carrs Welding Technologies Ltd,,-Split-,192.3,"1,128,106.73"
,8/11/2022,Expense,600665,Traditional English Guncases Ltd,,-Split-,"17,640.00","1,145,746.73"
,8/11/2022,Expense,600664,Traditional English Guncases Ltd,,Stock / Inventory Asset,"3,360.00","1,149,106.73"
,8/11/2022,Expense,r14/21,Outbound Cargo & Trophy,,Stock / Inventory Asset,"1,496.98","1,150,603.71"
,8/11/2022,Expense,,Jamie,,MARKETING/SELLING:Petrol,555.9,"1,151,159.61"
,9/11/2022,Expense Transaction (Bank Draft),Mary1998,Johnsons & Co Ltd,,EastX ****2310,"-1,320.00","1,149,839.61"
,9/11/2022,Expense Transaction (Bank Draft),Mary2002,Riflecraft Limited,,EastX ****2310,-59.34,"1,149,780.27"
,9/11/2022,Expense Transaction (Bank Draft),Mary1988,Beck Office,,EastX ****2310,-72,"1,149,708.27"
,9/11/2022,Expense Transaction (Bank Draft),Mary2001,Manchester Automatic Machining,,EastX ****2310,-309.6,"1,149,398.67"
,9/11/2022,Expense Transaction (Bank Draft),1424,The Gun & Allied Trade Benevolent Society,,Business Card,-380,"1,149,018.67"
,9/11/2022,Expense Transaction (Bank Draft),Mary1994,I. S. SWEETMAN GUN & RIFLE MAKERS LTD,,EastX ****2310,"-2,230.00","1,146,788.67"
,9/11/2022,Expense Transaction (Bank Draft),Mary1996,James E Kulczyk,,EastX ****2310,"-1,050.00","1,145,738.67"
,9/11/2022,Expense Transaction (Bank Draft),Mary1995,IPS Gunmaking Ltd,,EastX ****2310,"-3,337.00","1,142,401.67"
,9/11/2022,Expense Transaction (Bank Draft),Mary1989,BF&D LIMITED,,EastX ****2310,"-17,500.00","1,124,901.67"
,9/11/2022,Expense Transaction (Bank Draft),Mary2015,Air Source Climate Control Limited,,EastX ****2310,-525,"1,124,376.67"
,9/11/2022,Expense Transaction (Bank Draft),Mary1991,Debbie Thomas,,EastX ****2310,-685,"1,123,691.67"
,9/11/2022,Expense Transaction (Bank Draft),Mary2003,Derse Inc,,EastX ****2310,-471.26,"1,123,220.41"
,9/11/2022,Expense Transaction (Bank Draft),Mary1997,John Whitfield,,EastX ****2310,"-1,379.00","1,121,841.41"
,9/11/2022,Expense Transaction (Bank Draft),Mary2000,London Barrel Maker,,EastX ****2310,"-3,360.00","1,118,481.41"
,9/11/2022,Expense Transaction (Bank Draft),Mary1993,GMK,,EastX ****2310,"-1,181.40","1,117,300.01"
,9/11/2022,Expense Transaction (Bank Draft),Mary1984,A G Sinnett,,EastX ****2310,-284.14,"1,117,015.87"
,9/11/2022,Expense Transaction (Bank Draft),Mary1999,L W Butler,,EastX ****2310,"-8,022.00","1,108,993.87"
,9/11/2022,Expense Transaction (Bank Draft),Mary1990,Cooper Roberts,,EastX ****2310,-540,"1,108,453.87"
,9/11/2022,Expense Transaction (Bank Draft),Mary2013,Reiss Edwards Limited,,EastX ****2310,"-1,800.00","1,106,653.87"
,9/11/2022,Expense Transaction (Bank Draft),Mary2016,Cargo Overseas Limited,,EastX ****2310,-880,"1,105,773.87"
,9/11/2022,Expense Transaction (Bank Draft),Mary2017,"Le Arms, LLC",,EastX ****2310,"-2,810.00","1,102,963.87"
,9/11/2022,Expense Transaction (Bank Draft),Mary1987,ARC,,EastX ****2310,-60.62,"1,102,903.25"
,9/11/2022,Expense Transaction (Bank Draft),Mary1985,Aform Tooling Limited,,EastX ****2310,-972,"1,101,931.25"
,9/11/2022,Expense Transaction (Bank Draft),Mary1992,TimberLake Workshop,,EastX ****2310,-699.6,"1,101,231.65"
,9/11/2022,Expense,103227,SRS Freight Ltd,,Cost of sales,"2,694.70","1,103,926.35"
,9/11/2022,Expense,17096,Aform Tooling Limited,,Work in Progress,990,"1,104,916.35"
,9/11/2022,Expense,SLTI323740,Cargo Overseas Limited,,MARKETING/SELLING:Postage and Delivery,880,"1,105,796.35"
,9/11/2022,Expense,2934,DMC Custom Cartridges,,-Split-,800,"1,106,596.35"
,10/11/2022,Expense Transaction (Bank Draft),Mary1982,Kerast,,EastX ****2310,-504,"1,106,092.35"
,10/11/2022,Expense Transaction (Bank Draft),Mary2021,CA Bookkeeping Services Ltd,,EastX ****2310,"-1,056.00","1,105,036.35"
,10/11/2022,Expense Transaction (Bank Draft),Mary1981,Ray St Ledger & Sons,,EastX ****2310,-520.8,"1,104,515.55"
,10/11/2022,Expense Transaction (Bank Draft),Mary2010,Harper Office,,EastX ****2310,-289.87,"1,104,225.68"
,10/11/2022,Expense Transaction (Bank Draft),Mary2018,Recknagel,,EastX ****2310,-227.65,"1,103,998.03"
,10/11/2022,Expense,2021-047886,Recknagel,,-Split-,782.88,"1,104,780.91"
,10/11/2022,Expense Transaction (Bank Draft),Mary1983,SRS Freight Ltd,,EastX ****2310,"-8,211.78","1,096,569.13"
,10/11/2022,Expense Transaction (Bank Draft),Mary1980,Redhead International,,EastX ****2310,"-9,033.17","1,087,535.96"
,10/11/2022,Expense Transaction (Bank Draft),Mary1979,T F Wood & Son,,EastX ****2310,"-5,490.00","1,082,045.96"
,10/11/2022,Expense,,ElS And Co (Pty) Ltd,,ADMINISTRATION:Exchange Rate cost,38.5,"1,082,084.46"
,10/11/2022,Expense,U002534608,Peninsula,,-Split-,193.75,"1,082,278.21"
,10/11/2022,Expense Transaction (Bank Draft),Mary2009,Mayfair  Engineering,,EastX ****2310,"-16,929.20","1,065,349.01"
,11/11/2022,Expense Transaction (Bank Draft),Mary2029,Recknagel,,EastX ****2310,-782.88,"1,064,566.13"
,11/11/2022,Expense Transaction (Bank Draft),Mary2028,Schmidt Bender,,EastX ****2310,"-1,221.06","1,063,345.07"
,11/11/2022,Expense Transaction (Bank Draft),Mary1975,Swarovski Optik,,EastX ****2310,"-15,385.00","1,047,960.07"
,11/11/2022,Expense Transaction (Bank Draft),Mary2022,Hellmann Worlwide Logistics,,EastX ****2310,-25,"1,047,935.07"
,11/11/2022,Expense,,Schmidt Bender,,ADMINISTRATION:Exchange Rate cost,25.66,"1,047,960.73"
,11/11/2022,Expense Transaction (Bank Draft),Mary1978,Rodl & Partner,,EastX ****2310,"-5,040.00","1,042,920.73"
,11/11/2022,Expense Transaction (Bank Draft),Mary1976,Steve Kelly,,EastX ****2310,"-4,060.00","1,038,860.73"
,11/11/2022,Expense Transaction (Bank Draft),Mary1977,Smoothly Driven Logistics Ltd,,EastX ****2310,"-4,560.00","1,034,300.73"
,11/11/2022,Expense Transaction (Bank Draft),Mary2023,Phil Coggan,,EastX ****2310,"-10,000.00","1,024,300.73"
,12/11/2022,Expense Transaction (Bank Draft),Mary2007,Teague Precision Chokes Ltd,,EastX ****2310,"-1,129.13","1,023,171.60"
,12/11/2022,Expense Transaction (Bank Draft),Mary2006,Sam Faraway,,EastX ****2310,-900,"1,022,271.60"
,12/11/2022,Expense,1986,TimberLake Workshop,Gody and Sons Land Rover,-Split-,252,"1,022,523.60"
,12/11/2022,Expense Transaction (Bank Draft),Mary2030,Peninsula,,EastX ****2310,-193.75,"1,022,329.85"
,12/11/2022,Expense Transaction (Bank Draft),Mary2008,The Company of Gunmakers,,EastX ****2310,"-1,426.34","1,020,903.51"
,12/11/2022,Expense Transaction (Bank Draft),9199,Revolution Wines,,Apple Account,-1,"1,020,902.51"
,13/11/2022,Expense,9,Armurerie Du Bois De La Cote,,-Split-,"6,195.13","1,027,097.64"
,15/11/2022,Expense Transaction (Bank Draft),Mary2032,SASU BYG France,,EastX ****2310,"-1,414.42","1,025,683.22"
,15/11/2022,Expense,1347,SonySports Press Limited,,MARKETING/SELLING:Marketing,"1,794.00","1,027,477.22"
,15/11/2022,Expense,,Abacus GP Ltd,,MARKETING/SELLING:Car Rental,79.4,"1,027,556.62"
,15/11/2022,Expense,50,Ray St Ledger & Sons,,-Split-,452.1,"1,028,008.72"
,15/11/2022,Expense,3708,Tweed Media,,-Split-,"5,183.34","1,033,192.06"
,15/11/2022,Expense,51,Ray St Ledger & Sons,,-Split-,686.4,"1,033,878.46"
,15/11/2022,Expense,153,Nigel Westway,,-Split-,"1,311.00","1,035,189.46"
,15/11/2022,Expense,,Nick Coggan,,MARKETING/SELLING:Mileage,295,"1,035,484.46"
,15/11/2022,Expense,414898,P Higgins & Sons Ltd,,-Split-,"3,355.20","1,038,839.66"
,15/11/2022,Expense,2021064,Ian Clarke,,-Split-,523.38,"1,039,363.04"
,15/11/2022,Expense,464,London Barrel Maker,,-Split-,"9,240.00","1,048,603.04"
,15/11/2022,Expense,34315,Carrs Welding Technologies Ltd,,Work in Progress,81,"1,048,684.04"
,15/11/2022,Expense,43098,guntrader.co.uk,,ADMINISTRATION:Subscription,17.4,"1,048,701.44"
,16/11/2022,Expense Transaction (Bank Draft),Mary2048,Recknagel,,EastX ****2310,-790.2,"1,047,911.24"
,16/11/2022,Expense,2021-017930,Recknagel,,Stock / Inventory Asset,790.2,"1,048,701.44"
,16/11/2022,Expense,,SAS Liogier- Allary,,ADMINISTRATION:Exchange Rate cost,16.38,"1,048,717.82"
,16/11/2022,Expense,,Barton Gun Work,,Work in Progress,72,"1,048,789.82"
,16/11/2022,Expense,1,Mike Birch Ltd,,-Split-,438,"1,049,227.82"
,17/11/2022,Expense,NI152217,Big Yellow Self Storage,,-Split-,"1,132.88","1,050,360.70"
,17/11/2022,Expense,1992,TimberLake Workshop,,-Split-,117.6,"1,050,478.30"
,18/11/2022,Expense,008/2022,Traditional Fine Engraving,,Work in Progress,"6,521.74","1,057,000.04"
,18/11/2022,Expense,202100795,ETS Hubert SAS,,Work in Progress,"1,460.87","1,058,460.91"
,19/11/2022,Expense Transaction (Bank Draft),Mary2036,Peninsula,,EastX ****2310,-415.91,"1,058,045.00"
,19/11/2022,Expense,AVI8973918,DHL,,Stock / Inventory Asset,689.38,"1,058,734.38"
,19/11/2022,Expense,U002543057,Peninsula,,-Split-,415.91,"1,059,150.29"
,19/11/2022,Expense,OP/I784116,GMK,,-Split-,432.72,"1,059,583.01"
,19/11/2022,Expense,44763,The Company of Gunmakers,,-Split-,230.1,"1,059,813.11"
,19/11/2022,Expense,1432,Broadbent Leather goods,,-Split-,111.3,"1,059,924.41"
,22/11/2022,Vendor Credit,CN-18654,GWT Media,,ADMINISTRATION:Office Supplies,-1.2,"1,059,923.21"
,22/11/2022,Expense Transaction (Bank Draft),Mary2024,Romain Lepinois,,EastX ****2310,"-10,800.00","1,049,123.21"
,22/11/2022,Expense Transaction (Bank Draft),9359,Abacus GP Ltd,,EastX Bank,-79.4,"1,049,043.81"
,22/11/2022,Expense Transaction (Bank Draft),Mary2025,GWT Media,,-Split-,,"1,049,043.81"
,22/11/2022,Expense,,Cargo Overseas Limited,,MARKETING/SELLING:Postage and Delivery,396.46,"1,049,440.27"
,22/11/2022,Expense,75,The Gun & Allied Trade Benevolent Society,,MARKETING/SELLING:Subsistasnce and Entertainment expenses,76,"1,049,516.27"
,22/11/2022,Expense,44764,The Company of Gunmakers,,Work in Progress,55,"1,049,571.27"
,22/11/2022,Expense,,Perfect Solutions Decorations & Maintenance,,MARKETING/SELLING:Repair and maintenance,480,"1,050,051.27"
,22/11/2022,Expense,350,IPS Gunmaking Ltd,,Work in Progress,"3,337.00","1,053,388.27"
,22/11/2022,Expense,54222,Teague Precision Chokes Ltd,,-Split-,838.8,"1,054,227.07"
,22/11/2022,Expense,600675,Traditional English Guncases Ltd,,Work in Progress,"3,300.00","1,057,527.07"
,22/11/2022,Expense,9064038528,Parcelforce,,MARKETING/SELLING:Postage and Delivery,"1,174.07","1,058,701.14"
,22/11/2022,Expense,55,Ray St Ledger & Sons,,Work in Progress,"1,654.80","1,060,355.94"
,22/11/2022,Expense,,Andrew Ambrose,,Commission,"4,317.80","1,064,673.74"
,23/11/2022,Expense,3694,ElS And Co (Pty) Ltd,,-Split-,"3,615.00","1,068,288.74"
,23/11/2022,Expense,668096,Wbc,,-Split-,48.23,"1,068,336.97"
,23/11/2022,Expense,1946,L W Butler,,-Split-,"1,680.00","1,070,016.97"
,23/11/2022,Expense,S423600 - Pro-forma,Wbc,,-Split-,48.23,"1,070,065.20"
,23/11/2022,Expense,414899,P Higgins & Sons Ltd,,-Split-,"2,529.60","1,072,594.80"
,24/11/2022,Vendor Credit,,Armurerie Du Bois De La Cote,,ADMINISTRATION:Exchange Rate cost,-20.27,"1,072,574.53"
,24/11/2022,Expense Transaction (Bank Draft),Mary2040,Outbound Cargo & Trophy,,EastX ****2310,"-1,496.98","1,071,077.55"
,24/11/2022,Expense,,Mark Remmant,,MARKETING/SELLING:Travel Expense,234.4,"1,071,311.95"
,24/11/2022,Expense,,Slade Stevens,,MARKETING/SELLING:Travel Expense,714.08,"1,072,026.03"
,24/11/2022,Expense,,A G Sinnett,,-Split-,318.96,"1,072,344.99"
,24/11/2022,Expense,2021/219,Northwood Group,,Storage,"2,030.51","1,074,375.50"
,24/11/2022,Expense,103261,SRS Freight Ltd,,PreTransactions,"4,089.60","1,078,465.10"
,24/11/2022,Expense,1306,John Whitfield,,-Split-,330,"1,078,795.10"
,24/11/2022,Expense,103256,SRS Freight Ltd,,PreTransactions,774.48,"1,079,569.58"
,24/11/2022,Expense,538,ARC Ballistics Limited,,-Split-,384.6,"1,079,954.18"
,25/11/2022,Expense Transaction (Bank Draft),Mary2058,Cargo Overseas Limited,,EastX ****2310,-396.46,"1,079,557.72"
,25/11/2022,Expense,895681,M Mitchell (Gun Makers) Ltd,,-Split-,"14,040.00","1,093,597.72"
,25/11/2022,Expense,6208,Beck Office,,Bookkeeping & Payroll,72,"1,093,669.72"
,25/11/2022,Expense,414900,P Higgins & Sons Ltd,,-Split-,"1,800.00","1,095,469.72"
,26/11/2022,Expense Transaction (Bank Draft),Mary2056,Ford,,EastX ****2310,-550.42,"1,094,919.30"
,26/11/2022,Expense Transaction (Bank Draft),Mary2055,Talking Food,,EastX ****2310,"-3,000.00","1,091,919.30"
,26/11/2022,Expense Transaction (Bank Draft),Mary2060,The Shikar Club,,EastX ****2310,-100,"1,091,819.30"
,26/11/2022,Expense,,William Wild,,Work in Progress,"3,075.00","1,094,894.30"
,26/11/2022,Expense,103269,SRS Freight Ltd,,MARKETING/SELLING:Postage and Delivery,476.1,"1,095,370.40"
,26/11/2022,Expense,103278,SRS Freight Ltd,,Cost of sales,631.6,"1,096,002.00"
,26/11/2022,Expense,2003,TimberLake Workshop,,-Split-,"1,773.00","1,097,775.00"
,26/11/2022,Expense,92207729,Abacus GP Ltd,,MARKETING/SELLING:Car Rental,"1,326.87","1,099,101.87"
,26/11/2022,Expense,,Jamie,,MARKETING/SELLING:Petrol,646.19,"1,099,748.06"
,26/11/2022,Expense,103268,SRS Freight Ltd,,-Split-,"1,758.85","1,101,506.91"
,26/11/2022,Expense,Rig003,Ian Moran,,-Split-,"6,000.00","1,107,506.91"
,26/11/2022,Expense,103277,SRS Freight Ltd,,MARKETING/SELLING:Postage and Delivery,331.5,"1,107,838.41"
,28/11/2022,Expense,,Jerome  Lannoue,,-Split-,"2,033.97","1,109,872.38"
,29/11/2022,Expense Transaction (Bank Draft),Mary2054,Tweed Media,,EastX ****2310,"-5,183.34","1,104,689.04"
,29/11/2022,Expense Transaction (Bank Draft),Mary2041,Armurerie Du Bois De La Cote,,EastX ****2310,"-7,023.18","1,097,665.86"
,29/11/2022,Expense Transaction (Bank Draft),Mary2037,Ian Clarke,,EastX ****2310,-523.38,"1,097,142.48"
,29/11/2022,Expense Transaction (Bank Draft),Mary2042,Propel Finance No 1,,EastX ****2310,-218.16,"1,096,924.32"
,29/11/2022,Expense Transaction (Bank Draft),Mary2043,The Gun & Allied Trade Benevolent Society,,EastX ****2310,-76,"1,096,848.32"
,29/11/2022,Expense,17122,Aform Tooling Limited,,-Split-,248.4,"1,097,096.72"
,29/11/2022,Expense,92208422,Abacus GP Ltd,,MARKETING/SELLING:Car Rental,"1,045.12","1,098,141.84"
,29/11/2022,Expense,8202,Gamefair,,PreTransactions,"2,655.00","1,100,796.84"
,29/11/2022,Expense,600674,Traditional English Guncases Ltd,Gordy and Sons Land Rover,Cost of sales,"3,300.00","1,104,096.84"
,29/11/2022,Expense,211102,Mayfair  Engineering,,-Split-,"3,404.40","1,107,501.24"
,29/11/2022,Expense,2021/002,Northwood Group SAS,,Gross Pay,"6,352.44","1,113,853.68"
,29/11/2022,Expense,,The Shikar Club,,MARKETING/SELLING:Marketing,100,"1,113,953.68"
,29/11/2022,Expense,108215,Merkel Jagd,the cost includes Tax as the Expense suppose to be export.,-Split-,786.95,"1,114,740.63"
,30/11/2022,Expense Transaction (Bank Draft),Mary2045,Slade Stevens,,EastX ****2310,-714.08,"1,114,026.55"
,30/11/2022,Expense,,Mary Gil,,-Split-,894.15,"1,114,920.70"
,30/11/2022,Expense Transaction (Bank Draft),Mary2063,SAS Liogier- Allary,,EastX ****2310,-281.54,"1,114,639.16"
,30/11/2022,Expense Transaction (Bank Draft),Mary2044,Scott Wood,,EastX ****2310,"-2,800.00","1,111,839.16"
,30/11/2022,Expense Transaction (Bank Draft),Mary2049,Aerial Direct,,EastX ****2310,-158.92,"1,111,680.24"
,30/11/2022,Expense Transaction (Bank Draft),9200,Northwood USA,,Apple Account,"-6,820.65","1,104,859.59"
,30/11/2022,Expense Transaction (Bank Draft),Mary2062,ElS And Co (Pty) Ltd,,EastX ****2310,"-3,615.00","1,101,244.59"
,30/11/2022,Expense Transaction (Bank Draft),Mary2047,Andrew Ambrose,,EastX ****2310,"-4,317.80","1,096,926.79"
,30/11/2022,Expense Transaction (Bank Draft),Mary2046,Perfect Solutions Decorations & Maintenance,,EastX ****2310,-480,"1,096,446.79"
,30/11/2022,Expense,60,Ray St Ledger & Sons,,Work in Progress,"1,654.80","1,098,101.59"
,30/11/2022,Expense,,Northwood USA,,MARKETING/SELLING:Consultants,"6,820.65","1,104,922.24"
,30/11/2022,Expense,,Northwood Group,,Shared cost,"2,636.50","1,107,558.74"
,30/11/2022,Expense,Ancient20,Dirty laundry,,ADMINISTRATION:Cleaning Supplies,24,"1,107,582.74"
,30/11/2022,Expense,73742,Harper Office,,ADMINISTRATION:Office Supplies,630.43,"1,108,213.17"
,30/11/2022,Expense,201820,Debbie Thomas,,Stock / Inventory Asset,460,"1,108,673.17"
,30/11/2022,Expense,,Northwood Group,,Shared cost,"1,015.00","1,109,688.17"
,30/11/2022,Expense,154,Nigel Westway,,-Split-,"1,292.00","1,110,980.17"
,30/11/2022,Expense,157,I. S. SWEETMAN GUN & RIFLE MAKERS LTD,,Work in Progress,"2,200.00","1,113,180.17"
,30/11/2022,Expense,61,Ray St Ledger & Sons,,Work in Progress,"1,654.80","1,114,834.97"
,30/11/2022,Expense,,L & O Immobilien GMBH & Co KG,,ADMINISTRATION:Rent & Rates Expense,"10,666.11","1,125,501.08"
,30/11/2022,Expense Transaction (Bank Draft),1519,Redwood InnoTaxions,,Business Card,-70.97,"1,125,430.11"
,1/12/2022,Expense Transaction (Bank Draft),Mary2026,Wbc,,EastX ****2310,"-2,383.35","1,123,046.76"
,1/12/2022,Expense,10,Armurerie Du Bois De La Cote,,-Split-,"6,556.53","1,129,603.29"
,1/12/2022,Expense Transaction (Bank Draft),Mary2064,Big Yellow Self Storage,,EastX ****2310,"-1,132.88","1,128,470.41"
,1/12/2022,Expense Transaction (Bank Draft),9373,L & O Immobilien GMBH & Co KG,,EastX Bank,"-10,666.11","1,117,804.30"
,1/12/2022,Expense Transaction (Bank Draft),Mary2025,Worldpay,,EastX ****2310,"-2,390.29","1,115,414.01"
,1/12/2022,Expense Transaction (Bank Draft),1423,Stable Events Ltd,,Business Card,"-1,668.00","1,113,746.01"
,1/12/2022,Expense Transaction (Bank Draft),1425,Parcelforce,,Business Card,-411.93,"1,113,334.08"
,1/12/2022,Vendor Credit,698965,Jay Spark Co Ltd,,Stock / Inventory Asset,-61.04,"1,113,273.04"
,1/12/2022,Vendor Credit,,Wbc,,-Split-,-48.23,"1,113,224.81"
,1/12/2022,Expense,600626,Traditional English Guncases Ltd,,-Split-,"6,000.00","1,119,224.81"
,1/12/2022,Expense,1218,Cooper Roberts,,Storage,540,"1,119,764.81"
,1/12/2022,Expense,600644,Traditional English Guncases Ltd,,-Split-,121.2,"1,119,886.01"
,1/12/2022,Expense,40,Royal,,Cost of sales,"5,580.86","1,125,466.87"
,1/12/2022,Expense,8,Peter Boxall,,-Split-,400,"1,125,866.87"
,1/12/2022,Expense,,Jerome  Lannoue,,-Split-,"1,669.20","1,127,536.07"
,1/12/2022,Expense,18725,GWT Media,,ADMINISTRATION:Computer and Internet Expenses,253.8,"1,127,789.87"
,1/12/2022,Expense,76307,Kerast,,-Split-,240,"1,128,029.87"
,1/12/2022,Expense,76398,Kerast,,-Split-,"1,860.00","1,129,889.87"
,1/12/2022,Expense,AVI8844290,DHL,,MARKETING/SELLING:Postage and Delivery,485.94,"1,130,375.81"
,1/12/2022,Expense,5666,Buck's Club Limited,,ADMINISTRATION:Subscription,241.25,"1,130,617.06"
,1/12/2022,Expense,10221,Shooting Star,,-Split-,"3,384.00","1,134,001.06"
,1/12/2022,Expense,62,Ray St Ledger & Sons,,Work in Progress,90,"1,134,091.06"
,1/12/2022,Expense,15625PC21,Willis Towers Watson,,PreTransactions,"10,638.42","1,144,729.48"
,1/12/2022,Expense,6172,Buck's Club Limited,,MARKETING/SELLING:Subsistasnce and Entertainment expenses,24,"1,144,753.48"
,1/12/2022,Expense,16.2,T & D O'Neill,,Cost of sales,188,"1,144,941.48"
,1/12/2022,Expense,716758,Jay Spark Co Ltd,,Stock / Inventory Asset,336.34,"1,145,277.82"
,1/12/2022,Expense,17.2,T & D O'Neill,,Cost of sales,220,"1,145,497.82"
,1/12/2022,Expense,,LAMBETH,,ADMINISTRATION:Office Cleaning,160.65,"1,145,658.47"
,1/12/2022,Expense,,WORKMAN EDWARD,,-Split-,"1,852.62","1,147,511.09"
,1/12/2022,Expense,18/2022,T & D O'Neill,,Cost of sales,220,"1,147,731.09"
,1/12/2022,Expense,998,T F Wood & Son,,Stock / Inventory Asset,530,"1,148,261.09"
,1/12/2022,Expense,19.2,T & D O'Neill,,Cost of sales,240,"1,148,501.09"
,1/12/2022,Expense,182571008,Worldpay,,-Split-,145.47,"1,148,646.56"
,1/12/2022,Expense,6166,Buck's Club Limited,,MARKETING/SELLING:Subsistasnce and Entertainment expenses,16,"1,148,662.56"
,1/12/2022,Expense,39,Royal,,Storage,540,"1,149,202.56"
,1/12/2022,Expense,,Willis Towers Watson,,PreTransactions,375,"1,149,577.56"
,1/12/2022,Expense Transaction (Bank Draft),1540,Wbc,,-Split-,,"1,149,577.56"
,2/12/2022,Expense,order 242450,Lothar Walther,,-Split-,689.94,"1,150,267.50"
,2/12/2022,Expense,938972,Lothar Walther,,-Split-,"1,682.63","1,151,950.13"
,2/12/2022,Expense,6183,Buck's Club Limited,,MARKETING/SELLING:Subsistasnce and Entertainment expenses,90,"1,152,040.13"
,2/12/2022,Expense,RE-202112/14134,Karl Beier,,Stock / Inventory Asset,948.26,"1,152,988.39"
,2/12/2022,Expense,1,James Callaghan Services,,Work in Progress,"1,000.00","1,153,988.39"
,2/12/2022,Expense,211201,Mayfair  Engineering,,-Split-,"3,606.00","1,157,594.39"
,2/12/2022,Expense,2346,David Graham AU Ltd,,Work in Progress,"17,448.00","1,175,042.39"
,3/12/2022,Expense,92228884,Abacus GP Ltd,,MARKETING/SELLING:Car Rental,568,"1,175,610.39"
,3/12/2022,Expense,A2101562,Chichester Cars Ltd,,Car general expenses,433.3,"1,176,043.69"
,3/12/2022,Expense,44794,The Company of Gunmakers,,-Split-,194.07,"1,176,237.76"
,3/12/2022,Expense,18552,The Gun Trade Association,,MARKETING/SELLING:Marketing,600,"1,176,837.76"
,3/12/2022,Expense,1219,Cooper Roberts,,MARKETING/SELLING:Postage and Delivery,26.4,"1,176,864.16"
,6/12/2022,Expense,717280,Jay Spark Co Ltd,,Stock / Inventory Asset,68.16,"1,176,932.32"
,6/12/2022,Expense,7088,CA Bookkeeping Services Ltd,,Bookkeeping & Payroll,844.8,"1,177,777.12"
,6/12/2022,Expense,,Propel Finance No 1,,MARKETING/SELLING:Telephone Expense,218.16,"1,177,995.28"
,6/12/2022,Expense,44809,The Company of Gunmakers,,-Split-,567.04,"1,178,562.32"
,7/12/2022,Expense Transaction (Bank Draft),Mary2066,A G Sinnett,,EastX ****2310,-318.96,"1,178,243.36"
,7/12/2022,Expense,600686,Traditional English Guncases Ltd,,Accruals,"1,800.00","1,180,043.36"
,7/12/2022,Expense Transaction (Bank Draft),Mary2070,P Higgins & Sons Ltd,,EastX ****2310,"-5,155.20","1,174,888.16"
,7/12/2022,Expense Transaction (Bank Draft),Mary2067,Mary Gil,,EastX ****2310,-894.15,"1,173,994.01"
,7/12/2022,Expense Transaction (Bank Draft),Mary2077,Jerome  Lannoue,,EastX ****2310,"-2,048.97","1,171,945.04"
,7/12/2022,Expense Transaction (Bank Draft),Mary2068,Mark Remmant,,EastX ****2310,-234.4,"1,171,710.64"
,7/12/2022,Expense Transaction (Bank Draft),Mary2071,London Barrel Maker,,EastX ****2310,"-5,880.00","1,165,830.64"
,7/12/2022,Expense Transaction (Bank Draft),Mary2072,Jamie,,EastX ****2310,"-1,202.09","1,164,628.55"
,7/12/2022,Expense Transaction (Bank Draft),Mary2065,Dirty laundry,,EastX ****2310,-72,"1,164,556.55"
,7/12/2022,Expense Transaction (Bank Draft),Mary2075,Armurerie Du Bois De La Cote,,EastX ****2310,"-2,048.97","1,162,507.58"
,7/12/2022,Expense Transaction (Bank Draft),Mary2069,P Higgins & Sons Ltd,,EastX ****2310,"-2,529.60","1,159,977.98"
,7/12/2022,Expense Transaction (Bank Draft),Mary2074,Rentokil,,EastX ****2310,-352.78,"1,159,625.20"
,7/12/2022,Expense Transaction (Bank Draft),Mary2073,Nick Coggan,,EastX ****2310,-295,"1,159,330.20"
,7/12/2022,Expense,6761,Field Sports Publishing Inc,,MARKETING/SELLING:Marketing,"2,925.00","1,162,255.20"
,7/12/2022,Expense,1308,John Whitfield,,-Split-,450,"1,162,705.20"
,7/12/2022,Expense,,Jerome  Lannoue,,ADMINISTRATION:Bank & card charges,15,"1,162,720.20"
,7/12/2022,Expense,,Armurerie Du Bois De La Cote,,ADMINISTRATION:Exchange Rate cost,41.17,"1,162,761.37"
,7/12/2022,Expense Transaction (Bank Draft),Mary2076,Armurerie Du Bois De La Cote,,EastX ****2310,"-4,187.33","1,158,574.04"
,8/12/2022,Expense Transaction (Bank Draft),Mary2095,John Whitfield,,EastX ****2310,-330,"1,158,244.04"
,8/12/2022,Expense,,Traditional Fine Engraving,,ADMINISTRATION:Exchange Rate cost,52.55,"1,158,296.59"
,8/12/2022,Expense Transaction (Bank Draft),Mary2091,TimberLake Workshop,,EastX ****2310,"-2,142.60","1,156,153.99"
,8/12/2022,Expense Transaction (Bank Draft),Mary2083,Arms Restoration Services,,EastX ****2310,"-5,244.00","1,150,909.99"
,8/12/2022,Expense Transaction (Bank Draft),Mary2109,Cooper Roberts,,EastX ****2310,-26.4,"1,150,883.59"
,8/12/2022,Expense Transaction (Bank Draft),Mary2110,Traditional Fine Engraving,,EastX ****2310,"-6,574.29","1,144,309.30"
,8/12/2022,Expense Transaction (Bank Draft),Mary2090,DMC Custom Cartridges,,EastX ****2310,-800,"1,143,509.30"
,8/12/2022,Expense Transaction (Bank Draft),Mary2084,Barton Gun Work,,EastX ****2310,-72,"1,143,437.30"
,8/12/2022,Expense Transaction (Bank Draft),Mary2093,Gamefair,,EastX ****2310,"-2,655.00","1,140,782.30"
,8/12/2022,Expense Transaction (Bank Draft),Mary2088,Cooper Roberts,,EastX ****2310,"-1,620.00","1,139,162.30"
,8/12/2022,Expense Transaction (Bank Draft),9368,Northwood Group,,EastX Bank,"-116,779.30","1,022,383.00"
,8/12/2022,Expense Transaction (Bank Draft),Mary2092,Fox & Co Bespokw Ltd,,EastX ****2310,-228,"1,022,155.00"
,8/12/2022,Expense Transaction (Bank Draft),Mary2078,John Dickson & Son Ltd,,EastX ****2310,-606,"1,021,549.00"
,8/12/2022,Expense Transaction (Bank Draft),Mary2079,Traditional English Guncases Ltd,,EastX ****2310,"-29,400.00","992,149.00"
,8/12/2022,Expense Transaction (Bank Draft),Mary2085,Beck Office,,EastX ****2310,-72,"992,077.00"
,8/12/2022,Expense Transaction (Bank Draft),Mary2081,Aform Tooling Limited,,EastX ****2310,"-1,238.40","990,838.60"
,8/12/2022,Expense Transaction (Bank Draft),Mary2111,Peninsula,,EastX ****2310,-193.75,"990,644.85"
,8/12/2022,Expense Transaction (Bank Draft),Mary2087,Carrs Welding Technologies Ltd,,EastX ****2310,-273.3,"990,371.55"
,8/12/2022,Expense Transaction (Bank Draft),9370,Northwood Group UK Vendor,,EastX Bank,"-18,242.40","972,129.15"
,8/12/2022,Expense Transaction (Bank Draft),Mary2096,Lambeth borough Council,,EastX ****2310,"-1,297.00","970,832.15"
,8/12/2022,Expense Transaction (Bank Draft),Mary2080,L W Butler,,EastX ****2310,"-1,680.00","969,152.15"
,8/12/2022,Expense Transaction (Bank Draft),Mary2089,Debbie Thomas,,EastX ****2310,-460,"968,692.15"
,8/12/2022,Expense Transaction (Bank Draft),Mary2086,Broadbent Leather goods,,EastX ****2310,-111.3,"968,580.85"
,8/12/2022,Expense Transaction (Bank Draft),Mary2082,ARC Ballistics Limited,,EastX ****2310,-384.6,"968,196.25"
,8/12/2022,Expense,111288,A.S.I Ltd,,Cost of sales,154.8,"968,351.05"
,8/12/2022,Expense,,A G Sinnett,,MARKETING/SELLING:Postage and Delivery,182.45,"968,533.50"
,8/12/2022,Expense,,DHL,,MARKETING/SELLING:Misc,82.98,"968,616.48"
,8/12/2022,Expense Transaction (Bank Draft),Mary2094,Harper Office,,EastX ****2310,-630.43,"967,986.05"
,9/12/2022,Expense Transaction (Bank Draft),Mary2103,Swarovski Optik,,EastX ****2310,-0.5,"967,985.55"
,9/12/2022,Expense,23080,Hambrusch,,-Split-,"5,890.52","973,876.07"
,9/12/2022,Expense Transaction (Bank Draft),Mary2104,The Gun Trade Association,,EastX ****2310,-600,"973,276.07"
,9/12/2022,Expense Transaction (Bank Draft),Mary2105,Ray St Ledger & Sons,,EastX ****2310,"-7,130.10","966,145.97"
,9/12/2022,Expense Transaction (Bank Draft),Mary2107,Mayfair  Engineering,,EastX ****2310,"-3,404.40","962,741.57"
,9/12/2022,Expense Transaction (Bank Draft),Mary2108,The Courteney Boot Company,,EastX ****2310,"-8,786.33","953,955.24"
,9/12/2022,Expense Transaction (Bank Draft),Mary2102,Mike Birch Ltd,,EastX ****2310,-438,"953,517.24"
,9/12/2022,Expense Transaction (Bank Draft),9201,Northwood Group UK Vendor,,Apple Account,"-1,080.00","952,437.24"
,9/12/2022,Expense Transaction (Bank Draft),Mary2101,SRS Freight Ltd,,EastX ****2310,"-10,756.83","941,680.41"
,9/12/2022,Expense Transaction (Bank Draft),Mary2106,Teague Precision Chokes Ltd,,EastX ****2310,-838.8,"940,841.61"
,9/12/2022,Expense Transaction (Bank Draft),Mary2099,Phil Coggan,,EastX ****2310,"-11,660.00","929,181.61"
,9/12/2022,Expense Transaction (Bank Draft),Mary2098,Nigel Westway,,EastX ****2310,"-2,603.00","926,578.61"
,9/12/2022,Expense,8400077844,Northwood Group,,MARKETING/SELLING:Postage and Delivery,"1,357.00","927,935.61"
,9/12/2022,Expense,,A G Sinnett,,-Split-,319.81,"928,255.42"
,9/12/2022,Expense Transaction (Bank Draft),Mary2100,William Wild,,EastX ****2310,"-3,075.00","925,180.42"
,10/12/2022,Expense,1001/00089956,Edgar Brothers,,-Split-,81.91,"925,262.33"
,10/12/2022,Expense,2025,TimberLake Workshop,,-Split-,218.4,"925,480.73"
,10/12/2022,Expense,U002583489,Peninsula,,-Split-,193.75,"925,674.48"
,10/12/2022,Expense,44818,The Company of Gunmakers,,-Split-,185.11,"925,859.59"
,13/12/2022,Expense Transaction (Bank Draft),Mary2118,Field Sports Publishing Inc,,EastX ****2310,"-2,959.79","922,899.80"
,13/12/2022,Expense,,Field Sports Publishing Inc,,ADMINISTRATION:Exchange Rate cost,144.99,"923,044.79"
,13/12/2022,Expense Transaction (Bank Draft),Mary2121,McLaughin Custom Firearms,,EastX ****2310,"-6,511.39","916,533.40"
,13/12/2022,Expense Transaction (Bank Draft),Mary2115,CA Bookkeeping Services Ltd,,EastX ****2310,-844.8,"915,688.60"
,13/12/2022,Expense Transaction (Bank Draft),Mary2125,I. S. SWEETMAN GUN & RIFLE MAKERS LTD,,EastX ****2310,"-2,200.00","913,488.60"
,13/12/2022,Vendor Credit,,McLaughin Custom Firearms,,ADMINISTRATION:Exchange Rate cost,-132.87,"913,355.73"
,13/12/2022,Expense Transaction (Bank Draft),Mary2119,Forest Italia,,EastX ****2310,"-2,950.70","910,405.03"
,13/12/2022,Expense Transaction (Bank Draft),Mary2116,West London Shooting School,,EastX ****2310,"-2,733.60","907,671.43"
,13/12/2022,Expense Transaction (Bank Draft),Mary2124,IPS Gunmaking Ltd,,EastX ****2310,"-3,337.00","904,334.43"
,13/12/2022,Expense Transaction (Bank Draft),9364,Northwood GMBH,,EastX Bank,"-9,373.00","894,961.43"
,13/12/2022,Expense Transaction (Bank Draft),Mary2122,Holzwelt Cases,,EastX ****2310,-233.73,"894,727.70"
,13/12/2022,Expense Transaction (Bank Draft),Mary2117,Tweed Media,,EastX ****2310,"-1,848.00","892,879.70"
,13/12/2022,Expense Transaction (Bank Draft),9366,Abacus GP Ltd,,EastX Bank,"-1,326.87","891,552.83"
,13/12/2022,Expense Transaction (Bank Draft),Mary2126,Ian Moran,,EastX ****2310,"-6,000.00","885,552.83"
,13/12/2022,Expense Transaction (Bank Draft),Mary2120,Magic Safari Lodges,,EastX ****2310,"-3,072.48","882,480.35"
,13/12/2022,Expense,73938,Harper Office,,ADMINISTRATION:Office Supplies,147.12,"882,627.47"
,13/12/2022,Expense,103318,SRS Freight Ltd,,MARKETING/SELLING:Postage and Delivery,765.45,"883,392.92"
,13/12/2022,Expense,20.2,T & D O'Neill,,Cost of sales,220,"883,612.92"
,13/12/2022,Expense,2030,TimberLake Workshop,,-Split-,104.5,"883,717.42"
,13/12/2022,Expense,,Magic Safari Lodges,,ADMINISTRATION:Exchange Rate cost,29.03,"883,746.45"
,13/12/2022,Expense,,Holzwelt Cases,,ADMINISTRATION:Exchange Rate cost,16.33,"883,762.78"
,13/12/2022,Expense,103314,SRS Freight Ltd,,MARKETING/SELLING:Postage and Delivery,804.28,"884,567.06"
,13/12/2022,Expense,,Forest Italia,,ADMINISTRATION:Bank & card charges,15,"884,582.06"
,13/12/2022,Expense,80153157,LAMBETH,,ADMINISTRATION:Office Cleaning,142.62,"884,724.68"
,13/12/2022,Expense,103316,SRS Freight Ltd,,MARKETING/SELLING:Postage and Delivery,"1,232.39","885,957.07"
,13/12/2022,Expense,103313,SRS Freight Ltd,,MARKETING/SELLING:Postage and Delivery,677.62,"886,634.69"
,13/12/2022,Expense,103315,SRS Freight Ltd,,MARKETING/SELLING:Postage and Delivery,653.5,"887,288.19"
,13/12/2022,Expense Transaction (Bank Draft),Mary2123,SonySports Press Limited,,EastX ****2310,"-9,870.00","877,418.19"
,14/12/2022,Expense Transaction (Bank Draft),9365,Northwood Group SAS,,EastX Bank,"-17,900.00","859,518.19"
,14/12/2022,Expense Transaction (Bank Draft),Mary2134,DHL,,EastX ****2310,-300,"859,218.19"
,14/12/2022,Expense Transaction (Bank Draft),Mary2142,McLaughin Custom Firearms,,-Split-,,"859,218.19"
,14/12/2022,Expense Transaction (Bank Draft),Mary2141,DHL,,EastX ****2310,-300,"858,918.19"
,14/12/2022,Expense Transaction (Bank Draft),Mary2138,DHL,,EastX ****2310,-300,"858,618.19"
,14/12/2022,Expense Transaction (Bank Draft),Mary2135,DHL,,EastX ****2310,-300,"858,318.19"
,14/12/2022,Expense Transaction (Bank Draft),Mary2133,DHL,,EastX ****2310,-300,"858,018.19"
,14/12/2022,Expense Transaction (Bank Draft),Mary2140,DHL,,EastX ****2310,-300,"857,718.19"
,14/12/2022,Expense Transaction (Bank Draft),Mary2137,DHL,,EastX ****2310,-23.31,"857,694.88"
,14/12/2022,Expense Transaction (Bank Draft),Mary2139,DHL,,EastX ****2310,-300,"857,394.88"
,14/12/2022,Expense Transaction (Bank Draft),Mary2132,DHL,,EastX ****2310,-229.68,"857,165.20"
,14/12/2022,Expense Transaction (Bank Draft),Mary2136,DHL,,EastX ****2310,-300,"856,865.20"
,14/12/2022,Expense,2.11E+13,Northwood Group UK Vendor,,Cost of sales,334.8,"857,200.00"
,14/12/2022,Expense,,Swieton Brice,,MARKETING/SELLING:Travel Expense,43.69,"857,243.69"
,15/12/2022,Expense Transaction (Bank Draft),Mary2128,Jerome  Lannoue,,EastX ****2310,"-1,669.20","855,574.49"
,15/12/2022,Expense Transaction (Bank Draft),Mary2127,M Mitchell (Gun Makers) Ltd,,EastX ****2310,"-14,040.00","841,534.49"
,15/12/2022,Expense Transaction (Bank Draft),9367,Abacus GP Ltd,,EastX Bank,"-1,045.12","840,489.37"
,15/12/2022,Expense Transaction (Bank Draft),Mary2129,Coggan Simon Engraver,,EastX ****2310,"-30,000.00","810,489.37"
,15/12/2022,Expense,718158,Jay Spark Co Ltd,,Stock / Inventory Asset,17.04,"810,506.41"
,15/12/2022,Expense,43510,guntrader.co.uk,,ADMINISTRATION:Subscription,46.2,"810,552.61"
,15/12/2022,Expense,8400079235,Northwood Group,,MARKETING/SELLING:Postage and Delivery,206.57,"810,759.18"
,15/12/2022,Expense,,Jamie,,MARKETING/SELLING:Petrol,322.13,"811,081.31"
,15/12/2022,Expense,3721,Tweed Media,,-Split-,"6,360.00","817,441.31"
,16/12/2022,Expense Transaction (Bank Draft),Mary2130,Coggan Simon Engraver,,EastX ****2310,"-14,400.00","803,041.31"
,16/12/2022,Expense Transaction (Bank Draft),Mary2144,Traditional English Guncases Ltd,,EastX ****2310,"-10,000.00","793,041.31"
,16/12/2022,Expense,35,Steve Kelly,,-Split-,"4,576.86","797,618.17"
,16/12/2022,Expense Transaction (Bank Draft),9376,Royal,,EastX Bank,"-6,120.86","791,497.31"
,16/12/2022,Expense Transaction (Bank Draft),Mary2131,A G Sinnett,,EastX ****2310,-319.81,"791,177.50"
,17/12/2022,Expense Transaction (Bank Draft),1540,Kahles,,-Split-,,"791,177.50"
,17/12/2022,Expense Transaction (Bank Draft),Mary2145,Dallas Safari Club,,EastX ****2310,"-7,108.07","784,069.43"
,17/12/2022,Expense Transaction (Bank Draft),9372,Abacus GP Ltd,,EastX Bank,-568,"783,501.43"
,17/12/2022,Expense,,Kahles,,ADMINISTRATION:Exchange Rate cost,26.44,"783,527.87"
,17/12/2022,Expense,AVI9053621,DHL,,MARKETING/SELLING:Postage and Delivery,943.58,"784,471.45"
,17/12/2022,Expense,,Dallas Safari Club,,ADMINISTRATION:Exchange Rate cost,31.15,"784,502.60"
,17/12/2022,Expense,PO2021/179,SASU BYG France,,-Split-,"2,747.46","787,250.06"
,18/12/2022,Expense,NI153255,Big Yellow Self Storage,,-Split-,"1,132.88","788,382.94"
,18/12/2022,Expense,878015,LAMBETH,,ADMINISTRATION:Office Cleaning,142.62,"788,525.56"
,20/12/2022,Expense Transaction (Bank Draft),Mary2146,LAMBETH,,EastX ****2310,-320.9,"788,204.66"
,20/12/2022,Expense,470,London Barrel Maker,,-Split-,"6,480.00","794,684.66"
,20/12/2022,Expense,2021-0064,Revolution Wines,,MARKETING/SELLING:Postage and Delivery,30,"794,714.66"
,20/12/2022,Expense,9064189313````````,Parcelforce,,MARKETING/SELLING:Postage and Delivery,690.1,"795,404.76"
,21/12/2022,Expense Transaction (Bank Draft),Mary2149,eon,,EastX ****2310,-45.83,"795,358.93"
,21/12/2022,Expense Transaction (Bank Draft),Mary2151,Willis Towers Watson,,EastX ****2310,"-11,013.42","784,345.51"
,21/12/2022,Expense,44834,The Company of Gunmakers,,Work in Progress,80.56,"784,426.07"
,21/12/2022,Expense,1958,L W Butler,,Accruals,"1,134.00","785,560.07"
,21/12/2022,Expense,,A G Sinnett,,MARKETING/SELLING:Postage and Delivery,64.58,"785,624.65"
,21/12/2022,Expense,2021/2450,Rodl & Partner,,Accruals,"1,080.00","786,704.65"
,21/12/2022,Expense,103342,SRS Freight Ltd,,MARKETING/SELLING:Postage and Delivery,"1,022.46","787,727.11"
,21/12/2022,Expense,,WORKMAN EDWARD,,-Split-,689.13,"788,416.24"
,22/12/2022,Expense Transaction (Bank Draft),Mary2154,Parcelforce,,EastX ****2310,"-1,174.07","787,242.17"
,22/12/2022,Expense Transaction (Bank Draft),Mary2155,Shooting Star,,EastX ****2310,"-3,431.40","783,810.77"
,22/12/2022,Expense Transaction (Bank Draft),Mary2157,Jamie,,EastX ****2310,-322.13,"783,488.64"
,22/12/2022,Expense Transaction (Bank Draft),Mary2156,A G Sinnett,,EastX ****2310,-247.03,"783,241.61"
,22/12/2022,Expense,53,Ivenesa Arnaudova,,Work in Progress,350,"783,591.61"
,22/12/2022,Expense,17149,Aform Tooling Limited,,-Split-,"3,336.00","786,927.61"
,22/12/2022,Expense,52,Ivenesa Arnaudova,,-Split-,800,"787,727.61"
,22/12/2022,Expense,103345,SRS Freight Ltd,,MARKETING/SELLING:Postage and Delivery,"5,365.90","793,093.51"
,22/12/2022,Expense,109665,CJB Engineering,,-Split-,"1,500.00","794,593.51"
,22/12/2022,Expense,103344,SRS Freight Ltd,,MARKETING/SELLING:Postage and Delivery,"1,320.60","795,914.11"
,22/12/2022,Expense,,Shooting Star,,Cost of sales,47.4,"795,961.51"
,23/12/2022,Expense Transaction (Bank Draft),Mary2159,James Callaghan Services,,EastX ****2310,"-1,000.00","794,961.51"
,23/12/2022,Expense Transaction (Bank Draft),Mary2158,Kerast,,EastX ****2310,"-2,100.00","792,861.51"
,23/12/2022,Expense Transaction (Bank Draft),Mary2191,Steve Kelly,,EastX ****2310,"-4,576.86","788,284.65"
,23/12/2022,Expense,18752,Wireless Terminal Solutions,,-Split-,529.6,"788,814.25"
,23/12/2022,Expense,2056,TimberLake Workshop,,-Split-,"4,482.00","793,296.25"
,23/12/2022,Expense,253384,Knighthood International Security Ltd,,MARKETING/SELLING:Repair and maintenance,150,"793,446.25"
,23/12/2022,Expense,2054,TimberLake Workshop,,-Split-,99.6,"793,545.85"
,23/12/2022,Expense Transaction (Bank Draft),Mary2161,Hambrusch,,EastX ****2310,"-5,890.52","787,655.33"
,24/12/2022,Expense Transaction (Bank Draft),9202,GWT Media,,Apple Account,-450,"787,205.33"
,24/12/2022,Expense,AVI9071173,DHL,,MARKETING/SELLING:Postage and Delivery,625.14,"787,830.47"
,24/12/2022,Expense,22-Oct,Traditional Fine Engraving,,Work in Progress,"4,347.80","792,178.27"
,24/12/2022,Expense Transaction (Bank Draft),9377,TMC Ltd,,EastX Bank,"-57,742.80","734,435.47"
,25/12/2022,Expense,6245,Beck Office,,Bookkeeping & Payroll,72,"734,507.47"
,25/12/2022,Expense,72726,ARC,,ADMINISTRATION:Office Supplies,79.24,"734,586.71"
,26/12/2022,Expense,27311265,Ford,,MARKETING/SELLING:Car Rental,550.42,"735,137.13"
,27/12/2022,Expense,21025202,Ben Becker,,Cost of sales,821.2,"735,958.33"
,27/12/2022,Expense,39,BF&D LIMITED,,Work in Progress,"1,000.00","736,958.33"
,27/12/2022,Expense,,William Wild,,Work in Progress,"4,500.00","741,458.33"
,29/12/2022,Expense Transaction (Bank Draft),Mary2164,Ford,,EastX ****2310,-550.42,"740,907.91"
,29/12/2022,Expense,,Propel Finance No 1,,MARKETING/SELLING:Telephone Expense,218.16,"741,126.07"
,29/12/2022,Expense Transaction (Bank Draft),Mary2165,Propel Finance No 1,,EastX ****2310,-218.16,"740,907.91"
,30/12/2022,Vendor Credit,21247256,Swarovski Optik,,Cost of sales,-878.98,"740,028.93"
,30/12/2022,Expense,600695,Traditional English Guncases Ltd,,Accruals,"5,580.00","745,608.93"
,30/12/2022,Expense,600697,Traditional English Guncases Ltd,,Work in Progress,"3,300.00","748,908.93"
,30/12/2022,Expense,600696,Traditional English Guncases Ltd,,Work in Progress,"3,300.00","752,208.93"
,31/12/2022,Expense Transaction (Bank Draft),Mary2179,Mayfair  Engineering,,EastX ****2310,"-3,606.00","748,602.93"
,31/12/2022,Expense,,Northwood Group,,Shared cost,"2,636.50","751,239.43"
,31/12/2022,Expense Transaction (Bank Draft),Mary2176,John Whitfield,,EastX ****2310,-450,"750,789.43"
,31/12/2022,Expense Transaction (Bank Draft),Mary2182,Revolution Wines,,EastX ****2310,-30,"750,759.43"
,31/12/2022,Expense Transaction (Bank Draft),Mary2178,London Barrel Maker,,EastX ****2310,"-6,480.00","744,279.43"
,31/12/2022,Vendor Credit,,Field Sports Publishing Inc,,MARKETING/SELLING:Marketing,"-2,730.68","741,548.75"
,31/12/2022,Expense Transaction (Bank Draft),Mary2172,Edgar Brothers,,EastX ****2310,-81.91,"741,466.84"
,31/12/2022,Expense Transaction (Bank Draft),Mary2170,CJB Engineering,,EastX ****2310,"-1,500.00","739,966.84"
,31/12/2022,Expense Transaction (Bank Draft),Mary2175,GWT Media,,EastX ****2310,-28.8,"739,938.04"
,31/12/2022,Expense Transaction (Bank Draft),Mary2190,Worldpay,,EastX ****2310,-145.47,"739,792.57"
,31/12/2022,Expense Transaction (Bank Draft),9204,Lothar Walther,,Apple Account,"-1,974.53","737,818.04"
,31/12/2022,Expense Transaction (Bank Draft),Mary2188,Wbc,,-Split-,,"737,818.04"
,31/12/2022,Expense Transaction (Bank Draft),Mary2189,Wireless Terminal Solutions,,EastX ****2310,-529.6,"737,288.44"
,31/12/2022,Expense Transaction (Bank Draft),Mary2186,guntrader.co.uk,,EastX ****2310,-63.6,"737,224.84"
,31/12/2022,Expense Transaction (Bank Draft),Mary2171,Coggan Simon Engraver,,EastX ****2310,-40,"737,184.84"
,31/12/2022,Expense Transaction (Bank Draft),Mary2181,Ray St Ledger & Sons,,EastX ****2310,-90,"737,094.84"
,31/12/2022,Expense Transaction (Bank Draft),Mary2168,Aform Tooling Limited,,EastX ****2310,"-3,336.00","733,758.84"
,31/12/2022,Expense Transaction (Bank Draft),Mary2180,SRS Freight Ltd,,EastX ****2310,"-11,076.75","722,682.09"
,31/12/2022,Expense Transaction (Bank Draft),Mary2185,Tweed Media,,EastX ****2310,"-6,360.00","716,322.09"
,31/12/2022,Expense Transaction (Bank Draft),Mary2173,TimberLake Workshop,,EastX ****2310,-322.9,"715,999.19"
,31/12/2022,Expense Transaction (Bank Draft),Mary2188,Reimer Johannsen,,-Split-,,"715,999.19"
,31/12/2022,Expense Transaction (Bank Draft),Mary2192,Irons Brothers Ltd,,-Split-,,"715,999.19"
,31/12/2022,Expense Transaction (Bank Draft),Mary2188,Field Sports Publishing Inc,,-Split-,,"715,999.19"
,31/12/2022,Expense Transaction (Bank Draft),Mary2169,Broadbent Leather goods,,EastX ****2310,-202.5,"715,796.69"
,31/12/2022,Expense Transaction (Bank Draft),Mary2188,Traditional English Guncases Ltd,,-Split-,,"715,796.69"
,31/12/2022,Expense Transaction (Bank Draft),9203,Northwood USA,,Apple Account,"-9,630.95","706,165.74"
,31/12/2022,Expense Transaction (Bank Draft),Mary2184,The Company of Gunmakers,,EastX ****2310,"-1,231.32","704,934.42"
,31/12/2022,Expense Transaction (Bank Draft),Mary2174,GMK,,EastX ****2310,-432.72,"704,501.70"
,31/12/2022,Expense Transaction (Bank Draft),Mary2177,L W Butler,,EastX ****2310,"-1,134.00","703,367.70"
,31/12/2022,Expense Transaction (Bank Draft),Mary2167,A.S.I Ltd,,EastX ****2310,-154.8,"703,212.90"
,31/12/2022,Vendor Credit,,Irons Brothers Ltd,,PreTransactions,"-9,680.00","693,532.90"
,31/12/2022,Vendor Credit,CN 600630,Traditional English Guncases Ltd,,Stock / Inventory Asset,"-2,160.00","691,372.90"
,31/12/2022,Vendor Credit,,Wbc,,PreTransactions,-722.82,"690,650.08"
,31/12/2022,Expense,432731,Aerial Direct,,MARKETING/SELLING:Telephone Expense,157.93,"690,808.01"
,31/12/2022,Expense,,A G Sinnett,,-Split-,714.9,"691,522.91"
,31/12/2022,Expense,21.2,T & D O'Neill,,Cost of sales,160,"691,682.91"
,31/12/2022,Expense,37594,Irons Brothers Ltd,,-Split-,"11,616.00","703,298.91"
,31/12/2022,Expense,37595,Irons Brothers Ltd,,-Split-,"11,616.00","714,914.91"
,31/12/2022,Expense,186699425,Worldpay,,-Split-,149.89,"715,064.80"
,31/12/2022,Expense,015/2022,L & O Immobilien GMBH & Co KG,,ADMINISTRATION:Rent & Rates Expense,"10,666.12","725,730.92"
,31/12/2022,Expense,,Northwood Group,,Shared cost,"1,015.00","726,745.92"
,31/12/2022,Expense,2021/234,Northwood Group,,-Split-,"32,504.13","759,250.05"
,31/12/2022,Expense,GD1221,Northwood USA,,MARKETING/SELLING:Consultants,"9,630.95","768,881.00"
,31/12/2022,Expense,2021/004,Northwood Group SAS,,Gross Pay,"6,352.44","775,233.44"
,31/12/2022,Expense,22.2,T & D O'Neill,,Cost of sales,160,"775,393.44"
,31/12/2022,Expense Transaction (Bank Draft),Mary2183,Swieton Brice,,EastX ****2310,-43.69,"775,349.75"
Total for Payables,,,,,,,"-£180,803.85  ",
Accruals,,,,,,,,
,Beginning Balance,,,,,,,"30,050.00"
,31/01/2022,Ledger Entry,3015,,Being released to P&L,-Split-,"1,500.00","31,550.00"
,31/01/2022,Ledger Entry,3018,,business rates Jan 2021,-Split-,"1,297.00","32,847.00"
,31/01/2022,Ledger Entry,3018,,being accrual interest Jan 2021,-Split-,"9,282.88","42,129.88"
,28/02/2022,Ledger Entry,3046,,being accrual interest Feb  2021,-Split-,"9,282.00","51,411.88"
,28/02/2022,Ledger Entry,3038,,Jerome Feb wages,-Split-,"3,152.74","54,564.62"
,28/02/2022,Ledger Entry,3046,,business rates Feb 2021,-Split-,"1,297.00","55,861.62"
,1/3/2022,Ledger Entry,3047,,Jerome Feb Salary,-Split-,"-3,167.74","52,693.88"
,3/3/2022,Expense,1739,A T Miles,Floor plate gold inlay Cal 270,Payables,-130,"52,563.88"
,31/03/2022,Expense,2021/049,Northwood Group,Interest for period 31 Dec 20 - 31 Mar 21,Payables,"-18,564.00","33,999.88"
,30/04/2022,Ledger Entry,3112,,Accrual for s/n 19375,-Split-,"4,000.00","37,999.88"
,30/04/2022,Ledger Entry,3111,,Interest charge accrual for April,-Split-,"9,282.00","47,281.88"
,31/05/2022,Ledger Entry,3141,,Sidney Hiscox accessories,-Split-,"1,937.70","49,219.58"
,31/05/2022,Ledger Entry,3119,,CampusX parts priTaxely made by Brice s/n 19375,-Split-,-600,"48,619.58"
,31/05/2022,Ledger Entry,3115,,Staff Bonus May 2021 accrual,-Split-,"6,000.00","54,619.58"
,31/05/2022,Ledger Entry,3119,,CampusX parts priTaxely made by Brice s/n18743,-Split-,-600,"54,019.58"
,31/05/2022,Ledger Entry,3115,,Interest charge accrual for May,-Split-,"9,282.00","63,301.58"
,1/6/2022,Expense,72,Ray St Ledger & Sons,New CampusX D?R N 19375 Handed,Payables,"-1,379.00","61,922.58"
,30/06/2022,Ledger Entry,3175,,Accrual for Andy Miles Receipt for 14714,-Split-,267.65,"62,190.23"
,30/06/2022,Ledger Entry,3173,,Staff Bonus June 2021 accrual,-Split-,"6,000.00","68,190.23"
,30/06/2022,Vendor Credit,2021/117,Northwood Group,"Interest Calculation as 0f 31st  March 2021
Already Receiptd 27.846,88
New interest rate 26791,33(4.57% instead of 4.75%)

Period 31.12.2020-31.03.2021",Payables,"1,055.25","69,245.48"
,30/06/2022,Ledger Entry,3176,,Marc Newton Bonus accrual being released,-Split-,"-20,000.00","49,245.48"
,30/06/2022,Ledger Entry,3177,,rate for June accrual,-Split-,"1,297.00","50,542.48"
,30/06/2022,Expense,2021/119,Northwood Group,Interest Calculation Period 31.03.2021-30.06.2021,Payables,"-19,619.25","30,923.23"
,1/7/2022,Expense,1746,A T Miles,Scope rings gold inlaid Old English 14714,Payables,-267.65,"30,655.58"
,31/07/2022,Ledger Entry,3215,,Staff Bonus July 2021 accrual,-Split-,"6,000.00","36,655.58"
,31/07/2022,Ledger Entry,3217,,Accrual for S/N 7065,-Split-,"2,500.00","39,155.58"
,31/07/2022,Ledger Entry,3217,,Accrual for S/N 14802,-Split-,400,"39,555.58"
,31/07/2022,Ledger Entry,3217,,Accrual for S/N 18707,-Split-,"5,000.00","44,555.58"
,31/07/2022,Ledger Entry,3215,,Interest 2021  accrual,-Split-,"10,835.00","55,390.58"
,31/08/2022,Ledger Entry,3247,,Accrual for s/n 14653,-Split-,800,"56,190.58"
,31/08/2022,Ledger Entry,3247,,Accrual for s/n 14652,-Split-,800,"56,990.58"
,31/08/2022,Ledger Entry,3247,,Accrual for s/n 14645,-Split-,800,"57,790.58"
,31/08/2022,Ledger Entry,3247,,Accrual for s/n 14644,-Split-,800,"58,590.58"
,31/08/2022,Ledger Entry,3247,,Accrual for s/n 14498,-Split-,800,"59,390.58"
,31/08/2022,Ledger Entry,3247,,Accrual for s/n 14497,-Split-,800,"60,190.58"
,31/08/2022,Ledger Entry,3247,,Accrual for s/n 14436,-Split-,800,"60,990.58"
,31/08/2022,Ledger Entry,3247,,Accrual for s/n 14434,-Split-,800,"61,790.58"
,31/08/2022,Ledger Entry,3247,,Accrual for s/n 14433,-Split-,800,"62,590.58"
,31/08/2022,Ledger Entry,3247,,Accrual for Russell Gordy defender s/n RG1,-Split-,"38,334.00","100,924.58"
,31/08/2022,Ledger Entry,3249,,Interest 2021  accrual,-Split-,"10,835.00","111,759.58"
,31/08/2022,Ledger Entry,3249,,Staff Bonus July 2021 accrual,-Split-,"6,000.00","117,759.58"
,31/08/2022,Ledger Entry,3247,,Accrual for blacking s/n 18726,-Split-,"2,500.00","120,259.58"
,31/08/2022,Ledger Entry,3247,,Accrual for Swarovski Receipt John Reed,-Split-,"1,592.00","121,851.58"
,31/08/2022,Ledger Entry,3247,,Accrual for s/n 14654,-Split-,800,"122,651.58"
,1/9/2022,Expense,424,Johnsons & Co Ltd,Ancient B/B Rifle .375,Payables,-410,"122,241.58"
,1/9/2022,Expense,2021/0412,Rodl & Partner,Corporation Tax Return,Payables,-900,"121,341.58"
,30/09/2022,Ledger Entry,3279,,Giles Transaction for s/n 14625,-Split-,"4,400.00","125,741.58"
,30/09/2022,Ledger Entry,3281,,Staff Bonus Sept 2021 accrual,-Split-,"6,000.00","131,741.58"
,30/09/2022,Ledger Entry,3281,,Interest 2021  accrual,-Split-,"10,835.00","142,576.58"
,30/09/2022,Ledger Entry,3279,,Chip Mahan Set of double gun sleeves,-Split-,"1,020.00","143,596.58"
,30/09/2022,Ledger Entry,3279,,Chip Mahan Cartridge bag stamped with initials,-Split-,402,"143,998.58"
,30/09/2022,Expense,,Northwood Group,Interest calculation for period 30 June - 30 Sep 2021,Payables,"-32,504.13","111,494.45"
,1/10/2022,Expense,467,Johnsons & Co Ltd,"New D,.B. rifle 18707",Payables,-390,"111,104.45"
,6/10/2022,Expense,35,Royal,"N467 EOR - completion of work on above vehicle, carpet, upholstery work",Payables,"-34,983.33","76,121.12"
,18/10/2022,Expense,2021/1812,Rodl & Partner,Audit and Financial Statements,Payables,"-4,200.00","71,921.12"
,22/10/2022,Ledger Entry,3292,,Cases for s/n 14644,-Split-,-943.95,"70,977.17"
,22/10/2022,Ledger Entry,3292,,Cases for s/n 14498,-Split-,-943.95,"70,033.22"
,22/10/2022,Ledger Entry,3292,,Cases for s/n 14497,-Split-,-943.95,"69,089.27"
,22/10/2022,Ledger Entry,3292,,Cases for s/n 14436,-Split-,-943.95,"68,145.32"
,22/10/2022,Ledger Entry,3292,,Cases for s/n 14434,-Split-,-943.95,"67,201.37"
,22/10/2022,Ledger Entry,3292,,Cases for s/n 14433,-Split-,-943.95,"66,257.42"
,22/10/2022,Ledger Entry,3292,,Scope ring for s/n 19375,-Split-,-471,"65,786.42"
,22/10/2022,Ledger Entry,3292,,Reverse Cases for s/n 7065 accrual to COS,-Split-,"-1,500.00","64,286.42"
,22/10/2022,Ledger Entry,3292,,St ledger work s/n 18726 accrual to COS,-Split-,"-1,379.00","62,907.42"
,22/10/2022,Ledger Entry,3292,,Gold inlay 470 for Big Game s/n 18707 reverse to cost of sale,-Split-,-270,"62,637.42"
,22/10/2022,Ledger Entry,3292,,Cases for s/n 14645,-Split-,-943.95,"61,693.47"
,22/10/2022,Ledger Entry,3292,,Cases for s/n 14653,-Split-,-943.95,"60,749.52"
,22/10/2022,Ledger Entry,3292,,Cases for s/n 14652,-Split-,-943.95,"59,805.57"
,22/10/2022,Ledger Entry,3292,,Cases for s/n 14654,-Split-,-943.95,"58,861.62"
,31/10/2022,Ledger Entry,3317,,Jerome October salary,-Split-,"3,849.00","62,710.62"
,31/10/2022,Ledger Entry,3328,,Interest 2021  accrual,-Split-,"10,835.00","73,545.62"
,31/10/2022,Ledger Entry,3327,,Being accrual for s/n 14752,-Split-,"1,000.00","74,545.62"
,31/10/2022,Ledger Entry,3327,,Being accrual for s/n 1413,-Split-,"1,000.00","75,545.62"
,31/10/2022,Ledger Entry,3327,,Being accrual for s/n 14712,-Split-,"1,000.00","76,545.62"
,31/10/2022,Ledger Entry,3327,,Being accrual for s/n 14711,-Split-,"1,000.00","77,545.62"
,31/10/2022,Ledger Entry,3327,,Being accrual for s/n 14703,-Split-,"1,000.00","78,545.62"
,31/10/2022,Ledger Entry,3327,,Being accrual for s/n 14702,-Split-,"1,000.00","79,545.62"
,31/10/2022,Ledger Entry,3327,,Being accrual for s/n 14701,-Split-,"1,000.00","80,545.62"
,31/10/2022,Ledger Entry,3327,,Being accrual for s/n 14700,-Split-,"1,000.00","81,545.62"
,31/10/2022,Ledger Entry,3327,,Being accrual for s/n 14670,-Split-,"1,000.00","82,545.62"
,31/10/2022,Ledger Entry,3327,,Being accrual for s/n 14669,-Split-,"1,000.00","83,545.62"
,31/10/2022,Ledger Entry,3327,,Being accrual for s/n 14668,-Split-,"1,000.00","84,545.62"
,31/10/2022,Ledger Entry,3327,,Being accrual for s/n 14667,-Split-,"1,000.00","85,545.62"
,31/10/2022,Ledger Entry,3327,,Being accrual for s/n 14656,-Split-,"1,000.00","86,545.62"
,31/10/2022,Ledger Entry,3327,,Being accrual for s/n 14754,-Split-,"1,000.00","87,545.62"
,31/10/2022,Ledger Entry,3327,,Being accrual for s/n 14799,-Split-,"1,000.00","88,545.62"
,31/10/2022,Ledger Entry,3328,,Staff Bonus Oct 2021 accrual,-Split-,"6,000.00","94,545.62"
,31/10/2022,Ledger Entry,3327,,Being accrual for 19601,-Split-,"6,500.00","101,045.62"
,31/10/2022,Ledger Entry,3327,,Being accrual for s/n 14288,-Split-,"1,000.00","102,045.62"
,30/11/2022,Ledger Entry,3317R,,Jerome October salary,-Split-,"-3,849.00","98,196.62"
,30/11/2022,Ledger Entry,3364,,Interest 2021  accrual,-Split-,"10,835.00","109,031.62"
,30/11/2022,Ledger Entry,3364,,Staff Bonus Nov 2021 accrual,-Split-,"6,000.00","115,031.62"
,30/11/2022,Ledger Entry,3362,,Being accrual for s/n 7306 M,-Split-,"2,500.00","117,531.62"
,30/11/2022,Ledger Entry,3362,,Swiss canvas reversal,-Split-,"-15,000.00","102,531.62"
,30/11/2022,Ledger Entry,3362,,Being accrual for s/n 7070,-Split-,"8,000.00","110,531.62"
,30/11/2022,Ledger Entry,3362,,Being accrual for s/n 18785,-Split-,"3,500.00","114,031.62"
,30/11/2022,Ledger Entry,3362,,Being accrual for s/n 7067,-Split-,"1,000.00","115,031.62"
,30/11/2022,Ledger Entry,3362,,Being accrual for s/n 7250M,-Split-,"2,500.00","117,531.62"
,30/11/2022,Ledger Entry,3362,,Being accrual for s/n 18725,-Split-,"3,000.00","120,531.62"
,7/12/2022,Expense,600686,Traditional English Guncases Ltd,Green Canvas Rifle Case for .416 Falling Black Rifle,Payables,"-1,500.00","119,031.62"
,9/12/2022,Ledger Entry,3366,,being released to P&L  s/n 14706,-Split-,"-1,238.00","117,793.62"
,9/12/2022,Ledger Entry,3366,,being released to P&L s/n 19601,-Split-,"-7,150.00","110,643.62"
,9/12/2022,Ledger Entry,3366,,being released to P&L s/n 18726,-Split-,"-1,634.98","109,008.64"
,16/12/2022,Expense,35,Steve Kelly,Grip Cap engraving barbed wire/clover leaf pattern 7375M,Payables,-500,"108,508.64"
,16/12/2022,Expense,35,Steve Kelly,Bolt release catch celtic ribbon,Payables,-500,"108,008.64"
,16/12/2022,Expense,35,Steve Kelly,Bolt release catch celtic ribbon,Payables,-500,"107,508.64"
,16/12/2022,Ledger Entry,3369,,Business rate Transaction,-Split-,"-3,891.00","103,617.64"
,20/12/2022,Ledger Entry,3387,,December Salary,-Split-,"-48,000.00","55,617.64"
,21/12/2022,Expense,1958,L W Butler,"CLEAN BARRELS AND REMOVE PROTECTOR, PREP BARRELS AFTER BLACK, MAKE OFF WEDGE. MAKE 2 NEW PINS, ADDRESS L/H SEAR TO TRIGGER, ADDRESS WOODWORK. REMOVE COLOURS FROM INTERNALS TEST FIRE AND CLEAN",Payables,-945,"54,672.64"
,21/12/2022,Expense,2021/2450,Rodl & Partner,Corporation Tax Return,Payables,-900,"53,772.64"
,30/12/2022,Expense,600695,Traditional English Guncases Ltd,Oak and Leather Case for .600 19601,Payables,"-4,650.00","49,122.64"
,31/12/2022,Ledger Entry,3425,,Audit fee for Y. E  2021,-Split-,"8,250.00","57,372.64"
,31/12/2022,Ledger Entry,3425,,Accrual for Rifles being reversed,-Split-,"-29,401.77","27,970.87"
,31/12/2022,Ledger Entry,3418,,being accrual for   18709 for Johnson Receipt,-Split-,500,"28,470.87"
,31/12/2022,Ledger Entry,3418,,being accrual for case accessories  7109,-Split-,"1,455.00","29,925.87"
,31/12/2022,Ledger Entry,3425,,Marc Newton Bonus for 2021,-Split-,"15,000.00","44,925.87"
,31/12/2022,Ledger Entry,3421,,Staff Bonus Dec2021 accrual,-Split-,"6,000.00","50,925.87"
,31/12/2022,Expense,2021/234,Northwood Group,Oct and Nov interest,Payables,"-21,670.87","29,255.00"
,31/12/2022,Ledger Entry,3418,,being accrual for case accessories  7110,-Split-,"1,455.00","30,710.00"
,31/12/2022,Ledger Entry,3425,,Corporation tax  fee for Y. E  2021,-Split-,"2,250.00","32,960.00"
Total for Accruals,,,,,,,"£2,910.00  ",
Corporation tax,,,,,,,,
,Beginning Balance,,,,,,,"-37,386.05"
,14/04/2022,Fund Transfer,,,,EastX ****2310,"-31,957.57","-69,343.62"
,3/8/2022,Ledger Entry,3218,,Corporation tax Refund,-Split-,"69,800.17",456.55
,26/08/2022,Fund Transfer,,,,EastX ****2310,"-7,125.00","-6,668.45"
,12/10/2022,Fund Transfer,,,,EastX ****2310,"-7,125.00","-13,793.45"
Total for Corporation tax,,,,,,,"£23,592.60  ",
Deferred Tax,,,,,,,,
,Beginning Balance,,,,,,,"78,162.00"
Total for Deferred Tax,,,,,,,,
Net Pay,,,,,,,,
,26/01/2022,Ledger Entry,2994,,January 2021 staff salary,-Split-,"60,857.27","60,857.27"
,26/01/2022,Ledger Entry,2995,,Jerome Jan 2021 salary,-Split-,"-60,857.27",0
,28/02/2022,Ledger Entry,3038,,Feb 2021 wages,-Split-,"-57,899.04","-57,899.04"
,28/02/2022,Ledger Entry,3037,,Feb 2021 staff wages,-Split-,"57,899.04",0
,29/03/2022,Ledger Entry,3064,,Jerome march salary,-Split-,"-57,505.42","-57,505.42"
,29/03/2022,Ledger Entry,3063,,March 2021 salary,-Split-,"57,505.42",0
,29/04/2022,Ledger Entry,3082,,Jerome April wages,-Split-,"-60,084.33","-60,084.33"
,29/04/2022,Ledger Entry,3081,,April 2021 wages,-Split-,"60,084.33",0
,31/05/2022,Ledger Entry,3116,,May 2021 Staff wages,-Split-,"59,064.70","59,064.70"
,31/05/2022,Ledger Entry,3118,,May 2021 salary Transaction,-Split-,"-59,064.70",0
,25/06/2022,Ledger Entry,3162,,June 2021 salary,-Split-,"78,446.14","78,446.14"
,25/06/2022,Ledger Entry,3163,,M H Foley June 2021 wages,-Split-,"-78,446.14",0
,30/07/2022,Ledger Entry,3193,,July 2021 salary,-Split-,"56,446.41","56,446.41"
,30/07/2022,Ledger Entry,3194,,Max July Salary,-Split-,"-56,446.41",0
,26/08/2022,Ledger Entry,3228,,Max August salary,-Split-,"-55,833.97","-55,833.97"
,26/08/2022,Ledger Entry,3227,,August 2021staff wages,-Split-,"55,833.97",0
,30/09/2022,Ledger Entry,3255,,September 2021 Gross Salary,-Split-,"65,493.63","65,493.63"
,30/09/2022,Ledger Entry,3256,,September Wages,-Split-,"-42,614.87","22,878.76"
,1/10/2022,Ledger Entry,3257,,James  Sept wages,-Split-,"-22,878.76",0
,31/10/2022,Ledger Entry,3318,,J Dunbar  Oct salary,-Split-,"-60,483.17","-60,483.17"
,31/10/2022,Ledger Entry,3314,,October 2021 salary,-Split-,"60,718.07",234.9
,1/11/2022,Ledger Entry,3319,,Jerome October wages,-Split-,-234.9,0
,30/11/2022,Ledger Entry,3350,,James  November salary,-Split-,"-62,908.22","-62,908.22"
,30/11/2022,Ledger Entry,3349,,November 2021 Salary,-Split-,"62,908.22",0
,20/12/2022,Ledger Entry,3387,,December Salary,-Split-,"100,934.82","100,934.82"
,21/12/2022,Ledger Entry,3388,,Martin Dec 2021 salary,-Split-,"-100,934.82",0
Total for Net Pay,,,,,,,£0.00  ,
Orders in Hand/Deferred Income,,,,,,,,
,Beginning Balance,,,,,,,"997,618.86"
,6/1/2022,Receipt,12073,Armurerie Nouvelle,Cash Deposit Receipt for Swiss edition 7.5x55 14670,Receivables,"5,250.00","1,002,868.86"
,6/1/2022,Receipt,12073,Armurerie Nouvelle,Cash Deposit Receipt for Swiss edition 7.5x55 14434,Receivables,"5,250.00","1,008,118.86"
,6/1/2022,Receipt,12073,Armurerie Nouvelle,Cash Deposit Receipt for Swiss edition 7.5x55 14436,Receivables,"5,250.00","1,013,368.86"
,6/1/2022,Receipt,12073,Armurerie Nouvelle,Cash Deposit Receipt for Swiss edition 7.5x55 14497,Receivables,"5,250.00","1,018,618.86"
,6/1/2022,Receipt,12073,Armurerie Nouvelle,Cash Deposit Receipt for Swiss edition 7.5x55 14799,Receivables,"5,250.00","1,023,868.86"
,6/1/2022,Receipt,12073,Armurerie Nouvelle,Cash Deposit Receipt for Swiss edition 7.5x55 14754,Receivables,"5,250.00","1,029,118.86"
,6/1/2022,Receipt,12073,Armurerie Nouvelle,Cash Deposit Receipt for Swiss edition 7.5x55 14752,Receivables,"5,250.00","1,034,368.86"
,6/1/2022,Receipt,12073,Armurerie Nouvelle,Cash Deposit Receipt for Swiss edition 7.5x55 14713,Receivables,"5,250.00","1,039,618.86"
,6/1/2022,Receipt,12073,Armurerie Nouvelle,Cash Deposit Receipt for Swiss edition 7.5x55 14712,Receivables,"5,250.00","1,044,868.86"
,6/1/2022,Receipt,12073,Armurerie Nouvelle,Cash Deposit Receipt for Swiss edition 7.5x55 14711,Receivables,"5,250.00","1,050,118.86"
,6/1/2022,Receipt,12073,Armurerie Nouvelle,Cash Deposit Receipt for Swiss edition 7.5x55 14703,Receivables,"5,250.00","1,055,368.86"
,6/1/2022,Receipt,12073,Armurerie Nouvelle,Cash Deposit Receipt for Swiss edition 7.5x55 14702,Receivables,"5,250.00","1,060,618.86"
,6/1/2022,Receipt,12073,Armurerie Nouvelle,Cash Deposit Receipt for Swiss edition 7.5x55 14701,Receivables,"5,250.00","1,065,868.86"
,6/1/2022,Receipt,12073,Armurerie Nouvelle,Cash Deposit Receipt for Swiss edition 7.5x55 14700,Receivables,"5,250.00","1,071,118.86"
,6/1/2022,Receipt,12073,Armurerie Nouvelle,Cash Deposit Receipt for Swiss edition 7.5x55 14433,Receivables,"5,250.00","1,076,368.86"
,6/1/2022,Receipt,12073,Armurerie Nouvelle,Cash Deposit Receipt for Swiss edition 7.5x55 14669,Receivables,"5,250.00","1,081,618.86"
,6/1/2022,Receipt,12073,Armurerie Nouvelle,Cash Deposit Receipt for Swiss edition 7.5x55 14668,Receivables,"5,250.00","1,086,868.86"
,6/1/2022,Receipt,12073,Armurerie Nouvelle,Cash Deposit Receipt for Swiss edition 7.5x55 14667,Receivables,"5,250.00","1,092,118.86"
,6/1/2022,Receipt,12073,Armurerie Nouvelle,Cash Deposit Receipt for Swiss edition 7.5x55 14656,Receivables,"5,250.00","1,097,368.86"
,6/1/2022,Receipt,12073,Armurerie Nouvelle,Cash Deposit Receipt for Swiss edition 7.5x55 14288,Receivables,"5,250.00","1,102,618.86"
,6/1/2022,Receipt,12073,Armurerie Nouvelle,Cash Deposit Receipt for Swiss edition 7.5x55 14654,Receivables,"5,250.00","1,107,868.86"
,6/1/2022,Receipt,12073,Armurerie Nouvelle,Cash Deposit Receipt for Swiss edition 7.5x55 14653,Receivables,"5,250.00","1,113,118.86"
,6/1/2022,Receipt,12073,Armurerie Nouvelle,Cash Deposit Receipt for Swiss edition 7.5x55 14652,Receivables,"5,250.00","1,118,368.86"
,6/1/2022,Receipt,12073,Armurerie Nouvelle,Cash Deposit Receipt for Swiss edition 7.5x55 14645,Receivables,"5,250.00","1,123,618.86"
,6/1/2022,Receipt,12073,Armurerie Nouvelle,Cash Deposit Receipt for Swiss edition 7.5x55 14644,Receivables,"5,250.00","1,128,868.86"
,6/1/2022,Receipt,12073,Armurerie Nouvelle,Cash Deposit Receipt for Swiss edition 7.5x55 14498,Receivables,"5,250.00","1,134,118.86"
,8/1/2022,Receipt,12078,Francesco Lenzerini,"Cash Deposit Receipt for Highland Stalker .30-06
S/N to be confirmed",Receivables,900,"1,135,018.86"
,18/01/2022,Debit Memo,CN8532,Sheikh Salman Bin Ebrahim Al-Khalifa,"Cash Deposit Receipt for Mauser M98, 7 mm Rem Mag - Sheikh Salman 
(Total amount: EURO 14921.77 Not including Tax)
+Accessories",Receivables,"-4,973.92","1,130,044.94"
,18/01/2022,Debit Memo,CN8532,Sheikh Salman Bin Ebrahim Al-Khalifa,"Cash Deposit Receipt for Mauser M98, 300 Win Mag - Sheikh Salman
(Total amount: EURO 14921.77 Not including Tax)
+Accessories",Receivables,"-4,973.92","1,125,071.02"
,18/01/2022,Debit Memo,CN8532,Sheikh Salman Bin Ebrahim Al-Khalifa,"Cash Deposit Receipt for Mauser M98, 7 mm Rem Mag - Sheikh Khalid
(Total amount: EURO 14481.92 Not including Tax)",Receivables,"-4,827.31","1,120,243.71"
,1/2/2022,Ledger Entry,3371,,Order in hand adjustment,-Split-,438.32,"1,120,682.03"
,4/2/2022,Receipt,12131,Vance Daigle,"Cash Deposit for CampusX 410 shotgun s/n 18737
Receipt 9963: £10,000 paid",Receivables,"25,000.00","1,145,682.03"
,28/02/2022,Ledger Entry,3045,,Viscount Jonathan s/n 7102 being released,-Split-,"-9,750.00","1,135,932.03"
,28/02/2022,Ledger Entry,3045,,David Modesett s/n 7375M being released,-Split-,"-10,011.50","1,125,920.53"
,9/3/2022,Receipt,12199,Tommy Salmon,"Cash Deposit for London Best .500 Jeffery S/N 7104

Total: £25,600",Receivables,"8,544.57","1,134,465.10"
,23/03/2022,Receipt,12236,Ve?koobchod zbrane spol. s.r.o.,"Cash Deposit Receipt for Big Game .416 DSB
Grade 8
London Fit Silver Oval
One letter engraved on oval
Leather covered recoil pad
Elasticated bullet pouch",Receivables,"5,000.00","1,139,465.10"
,24/03/2022,Receipt,12241,HH Sheikh Mohammed Al-Sharqi,Cash Deposit Receipt for CampusX .500S/N 18765,Receivables,"50,000.00","1,189,465.10"
,24/03/2022,Receipt,12239,HH Sheikh Mohammed Al-Sharqi,Cash Deposit Receipt for London Best .500 Jeffery S/N 7105,Receivables,"15,000.00","1,204,465.10"
,24/03/2022,Receipt,12242,HH Sheikh Mohammed Al-Sharqi,Cash Deposit Receipt for CampusX .350 No2 Ancient S/N 18750,Receivables,"50,000.00","1,254,465.10"
,24/03/2022,Receipt,12243,HH Sheikh Mohammed Al-Sharqi,Cash Deposit Receipt for CampusX .470 S/N 18757,Receivables,"50,000.00","1,304,465.10"
,24/03/2022,Receipt,12240,HH Sheikh Mohammed Al-Sharqi,Cash Deposit Receipt for CampusX .450-400 S/N 18722,Receivables,"50,000.00","1,354,465.10"
,30/03/2022,Receipt,12270,Chris Dianda,Cash Deposit Receipt for CampusX .577 S/N 19577,Receivables,"25,000.00","1,379,465.10"
,30/03/2022,Receipt,12270,Chris Dianda,Cash Deposit Receipt for CampusX .600 S/N 19602,Receivables,"24,450.00","1,403,915.10"
,30/03/2022,Receipt,12265,Sheikh Khalid Bin Ibrahim Al-Khalifa,"Cash Deposit for 7mm Rem Mag Custom rifle S/N 14641

Total: £27,599",Receivables,"15,000.00","1,418,915.10"
,31/03/2022,Ledger Entry,3071,,Being released to P & L Don Alberto Bailleres Gonzalez s/n 14586,-Split-,"-10,000.00","1,408,915.10"
,21/04/2022,Receipt,12323,Giancarlo Lugli,"Cash Deposit Receipt for Special Edition W.D.M. Bell rifle 40 of 50 S/N 14615

17,000 euros total",Receivables,"1,000.00","1,409,915.10"
,26/04/2022,Reimbursement,12430,John Doe,Refund,Cash Reserve,"-3,914.58","1,406,000.52"
,26/04/2022,Receipt,12346,John Doe,Cash Deposit Receipt for .416 Ancient DSB B/A rifle with grade 5 wood,Receivables,"4,697.50","1,410,698.02"
,30/04/2022,Ledger Entry,3112,,being released to P&L s/n 19375 R Holden,-Split-,"-18,550.00","1,392,148.02"
,30/04/2022,Receipt,12373,Laurens  Sliepenbeek,Cash Deposit for London Best .300 S/N 7108,Receivables,"11,056.98","1,403,205.00"
,30/04/2022,Ledger Entry,3112,,"being released to P&L s/n 18743 Sheikh 
Al-Sharqi",-Split-,"-10,011.00","1,393,194.00"
,8/5/2022,Receipt,12387,Mr Roger Karlsson,"Cash Deposit for Highland Stalker .30-06 14747
Total £10699 + Tax",Receivables,"3,750.00","1,396,944.00"
,11/5/2022,Receipt,12398,Corey Knowlton,Cash Deposit for London Best .404 Jeff S/N 7106,Receivables,"18,000.00","1,414,944.00"
,11/5/2022,Receipt,12399,David Modesett,"Cash Deposit Receipt for Ancient Land Rover Defender as per signed specifications

Total price £120,000.00 + Extras",Receivables,"60,000.00","1,474,944.00"
,24/05/2022,Receipt,12442,Glenn Kendall,Stage Transaction for CampusX double rifle .416 Ancient S/N 19600,Receivables,"35,000.00","1,509,944.00"
,24/05/2022,Receipt,12443,HH Sheikh Mohammed Al-Sharqi,Stage Transaction for 12 bore shotgun S/N 18717,Receivables,"28,000.00","1,537,944.00"
,24/05/2022,Receipt,12443,HH Sheikh Mohammed Al-Sharqi,Stage Transaction for 12 bore shotgun S/N 18718,Receivables,"24,000.00","1,561,944.00"
,24/05/2022,Receipt,12443,HH Sheikh Mohammed Al-Sharqi,Stage Transaction for 12 bore shotgun S/N 18719,Receivables,"24,000.00","1,585,944.00"
,24/05/2022,Receipt,12443,HH Sheikh Mohammed Al-Sharqi,Stage Transaction for 12 bore shotgun S/N 18720,Receivables,"24,000.00","1,609,944.00"
,25/05/2022,Receipt,12444,David Modesett,Second Cash Deposit Receipt for 28 bore CampusX Shotgun S/N 18727,Receivables,"45,000.00","1,654,944.00"
,25/05/2022,Receipt,12444,David Modesett,Second Cash Deposit Receipt for 28 bore CampusX Shotgun S/N 18728,Receivables,"45,000.00","1,699,944.00"
,28/05/2022,Receipt,12449,Thomas Hill,Cash Deposit Receipt for .350 Ancient London Best Vintage S/N 7070,Receivables,"10,000.00","1,709,944.00"
,28/05/2022,Debit Memo,12450,Sheikh Salman Bin Ebrahim Al-Khalifa,Receipt 10859,Receivables,"-5,000.00","1,704,944.00"
,31/05/2022,Ledger Entry,3139,,Sarfaraz Metio being released to p&l inv no 11794,-Split-,"-3,821.00","1,701,123.00"
,31/05/2022,Ledger Entry,3179,,"LTC Released Gordy and Son (Modessett)
s/n 18728",-Split-,"-60,000.00","1,641,123.00"
,31/05/2022,Ledger Entry,3139,,Sidney Hiscox onvoice no 11992 being relelased  to P & L,-Split-,"-2,000.00","1,639,123.00"
,31/05/2022,Ledger Entry,3179,,"LTC Released Gordy and Son (Modessett)
s/n 18727",-Split-,"-60,000.00","1,579,123.00"
,9/6/2022,Receipt,12489,Declan Morrison,"Cash Deposit Receipt for Highland Stalker .275 Ancient S/N 14672

Total: £12,306 inc Tax",Receivables,"5,000.00","1,584,123.00"
,9/6/2022,Receipt,12488,Carl King,Cash Deposit Receipt for Mauser .30-06 barrel,Receivables,500,"1,584,623.00"
,30/06/2022,Ledger Entry,3157,,Cash Deposit released for Delcan Morrison s/n 14672,-Split-,"-5,000.00","1,579,623.00"
,30/06/2022,Ledger Entry,3157,,Cash Deposit released for Roger Karlsson s/n 14747,-Split-,"-3,750.00","1,575,873.00"
,30/06/2022,Ledger Entry,3157,,Patrick Slater s/n 18698 LTC release,-Split-,"-45,000.00","1,530,873.00"
,30/06/2022,Ledger Entry,3157,,Chris Dianda s/n 19602 LTC release,-Split-,"-30,000.00","1,500,873.00"
,30/06/2022,Receipt,12545,HH Sheikh Mohammed Al-Sharqi:.30-06 London Best S/N 7110,Cash Deposit Receipt for .30-06 London best S/N 7110,Receivables,"15,000.00","1,515,873.00"
,30/06/2022,Receipt,12551,Patrick Slater,Stage Transaction for CampusX .500 18698,Receivables,"30,000.00","1,545,873.00"
,30/06/2022,Receipt,12549,Glenn Kendall,Stage Transaction for CampusX double rifle .416 Ancient S/N 19600,Receivables,"10,000.00","1,555,873.00"
,30/06/2022,Receipt,12546,HH Sheikh Mohammed Al-Sharqi:.600 Hippo CampusX,"Cash Deposit Receipt for CampusX .600 NE ""Hippo"" double rifle S/N TBC",Receivables,"50,000.00","1,605,873.00"
,30/06/2022,Receipt,12547,HH Sheikh Mohammed Al-Sharqi,Stage Transaction for CampusX .470 URB S/N 18747,Receivables,"20,000.00","1,625,873.00"
,30/06/2022,Ledger Entry,3157,,Cash Deposit released for Giancarlo Lugli Morrison s/n 14615,-Split-,"-1,000.00","1,624,873.00"
,30/06/2022,Ledger Entry,3157,,Glenn Kendall s/n 19600 LTC release,-Split-,"-45,000.00","1,579,873.00"
,30/06/2022,Receipt,12544,HH Sheikh Mohammed Al-Sharqi:.223 London  Best S/N 7109,Cash Deposit Receipt for .223 London best S/N 7109,Receivables,"15,000.00","1,594,873.00"
,1/7/2022,Receipt,12543,HH Sheikh Mohammed Al-Sharqi:.300 H&H Zebra gun S/N 7101,Cash Deposit Receipt for Zebra gun S/N 7101,Receivables,"30,000.00","1,624,873.00"
,5/7/2022,Receipt,12560,Christopher J Barber,Cash Deposit Receipt for London Best .350 Ancient S/N 7111,Receivables,"8,805.00","1,633,678.00"
,22/07/2022,Receipt,12609,Russell Gordy,Cash Deposit Receipt for Ancient Land Rover Defender as per order confirmation,Receivables,"75,000.00","1,708,678.00"
,30/07/2022,Ledger Entry,3208,,Cash Deposit released to P & L Francesco Lenzerini s/n 11206,-Split-,-900,"1,707,778.00"
,30/07/2022,Ledger Entry,3208,,Cash Deposit released to P & L John Doe s/n 11201,-Split-,"-4,697.50","1,703,080.50"
,30/07/2022,Ledger Entry,3208,,Cash Deposit released to P & L  Velkoobchod Zbrane s/n 12732,-Split-,"-5,000.00","1,698,080.50"
,30/07/2022,Ledger Entry,3208,,Cash Deposit released to P & L  Rom Shaffer s/n 7065,-Split-,"-9,055.22","1,689,025.28"
,31/08/2022,Ledger Entry,3248,,Armurerie Nouvelle Cash Deposit being released  s/n 14645,-Split-,"-5,250.00","1,683,775.28"
,31/08/2022,Ledger Entry,3248,,Armurerie Nouvelle Cash Deposit being released  s/n 14644,-Split-,"-5,250.00","1,678,525.28"
,31/08/2022,Ledger Entry,3248,,Armurerie Nouvelle Cash Deposit being released  s/n 14498,-Split-,"-5,250.00","1,673,275.28"
,31/08/2022,Ledger Entry,3248,,Armurerie Nouvelle Cash Deposit being released  s/n 14497,-Split-,"-5,250.00","1,668,025.28"
,31/08/2022,Ledger Entry,3248,,Armurerie Nouvelle Cash Deposit being released  s/n 14436,-Split-,"-5,250.00","1,662,775.28"
,31/08/2022,Ledger Entry,3248,,Armurerie Nouvelle Cash Deposit being released  s/n 14434,-Split-,"-5,250.00","1,657,525.28"
,31/08/2022,Ledger Entry,3248,,Armurerie Nouvelle Cash Deposit being released  s/n 14433,-Split-,"-5,250.00","1,652,275.28"
,31/08/2022,Ledger Entry,3240,,Russell Gordy 1/3 defender 110 series Cash Deposit released s/n RG1,-Split-,"-50,000.00","1,602,275.28"
,31/08/2022,Ledger Entry,3240,,Sheikh Khalid Bin Ibrahim Al-Khalifa Cash Deposit released  s/n 14641,-Split-,"-15,000.00","1,587,275.28"
,31/08/2022,Ledger Entry,3248,,Armurerie Nouvelle Cash Deposit being released  s/n 14654,-Split-,"-5,250.00","1,582,025.28"
,31/08/2022,Ledger Entry,3248,,Armurerie Nouvelle Cash Deposit being released  s/n 14653,-Split-,"-5,250.00","1,576,775.28"
,31/08/2022,Ledger Entry,3248,,Armurerie Nouvelle Cash Deposit being released  s/n 14652,-Split-,"-5,250.00","1,571,525.28"
,2/9/2022,Receipt,12852,Chris Dianda,Cash Deposit Receipt for CampusX .600 S/N 19602,Receivables,"30,000.00","1,601,525.28"
,2/9/2022,Receipt,12852,Chris Dianda,Cash Deposit Receipt for CampusX .577 S/N 19577,Receivables,"30,000.00","1,631,525.28"
,15/09/2022,Receipt,12884,HH Sheikh Mohammed Al-Sharqi,"Cash Deposit Receipt for first Ancient Cannon: 9 Pounder cannon with double R Ancient logo and cast iron Garrison gun carriage

Total: £25,000 ex Tax",Receivables,"12,500.00","1,644,025.28"
,21/09/2022,Receipt,12900,TXAT,"Cash Deposit Receipt for London Best .416 Ancient by John Ancient & Co S/N 7120 as per order confirmation

Total excluding engraving: £40,125.00",Receivables,"15,000.00","1,659,025.28"
,30/09/2022,Ledger Entry,3269,,LTC release Chris Dianda s/n 19602,-Split-,"-25,000.00","1,634,025.28"
,30/09/2022,Receipt,12917,Thomas Hill,"Second Cash Deposit Receipt for CampusX double rifle .350 No2 Ancient calibre S/N 18749
As per Order Confirmation

Already Receiptd and paid: £31,500 (Receipt 11179)",Receivables,"31,500.00","1,665,525.28"
,30/09/2022,Ledger Entry,3269,,LTC release Tom Hill s/n 18749,-Split-,"-50,000.00","1,615,525.28"
,1/10/2022,Receipt,12922,Chris Dianda,Cash Deposit Receipt for CampusX .600 S/N 19602,Receivables,"50,000.00","1,665,525.28"
,19/10/2022,Receipt,12975,Sheikh Abdullah Faisal Al-Thani,"Cash Deposit Receipt for .500 NE double rifle CampusX S/N 18766

Total: 95,000.00",Receivables,"23,750.00","1,689,275.28"
,22/10/2022,Receipt,12987,HH Sheikh Mohammed Al-Sharqi,"Cash Deposit Receipt for Safari Tent 3x6m
Total: £21,357.00",Receivables,"11,000.00","1,700,275.28"
,22/10/2022,Receipt,12991,Tarek Mahmoud,"Second Cash Deposit Receipt for Falling Block S/N 18785

Total £52,450.00",Receivables,"16,312.50","1,716,587.78"
,22/10/2022,Receipt,12990,Corey Knowlton,Second Cash Deposit for London Best .404 Jeff S/N 7106,Receivables,"8,100.00","1,724,687.78"
,22/10/2022,Receipt,12987,HH Sheikh Mohammed Al-Sharqi,"Cash Deposit Receipt for Safari Tent 9x12m
Total: £54,588.00",Receivables,"27,000.00","1,751,687.78"
,22/10/2022,Receipt,12987,HH Sheikh Mohammed Al-Sharqi,"Cash Deposit Receipt for Safari Tent 9x9m
Total: £47,575.50",Receivables,"24,000.00","1,775,687.78"
,22/10/2022,Receipt,12987,HH Sheikh Mohammed Al-Sharqi,"Cash Deposit Receipt for Safari Tent 9x9m
Total: £47,575.50",Receivables,"24,000.00","1,799,687.78"
,28/10/2022,Receipt,13026,HH Sheikh Mohammed Al-Sharqi:450 RB set of 8 18806,Cash Deposit Receipt for CampusX .450 Ancient set of 8 S/N 18806,Receivables,"30,000.00","1,829,687.78"
,28/10/2022,Receipt,13029,HH Sheikh Mohammed Al-Sharqi:.577 RB set of 8 18809,Cash Deposit Receipt for CampusX .577 set of 8 S/N 18809,Receivables,"30,000.00","1,859,687.78"
,28/10/2022,Receipt,13023,HH Sheikh Mohammed Al-Sharqi:.275 RB set of 8 18803,Cash Deposit Receipt for CampusX .275 No2 Ancient set of 8 S/N 18803,Receivables,"30,000.00","1,889,687.78"
,28/10/2022,Receipt,13025,HH Sheikh Mohammed Al-Sharqi:.416 RB set of 8 18805,Cash Deposit Receipt for CampusX .416 No2 Ancient set of 8 S/N 18805,Receivables,"30,000.00","1,919,687.78"
,28/10/2022,Receipt,13030,HH Sheikh Mohammed Al-Sharqi:.600 RB set of 8,Cash Deposit Receipt for CampusX .600 set of 8 S/N 18810,Receivables,"30,000.00","1,949,687.78"
,28/10/2022,Receipt,13028,HH Sheikh Mohammed Al-Sharqi:500 RB set of 8 18808,Cash Deposit Receipt for CampusX .500 Ancient set of 8 S/N 18808,Receivables,"30,000.00","1,979,687.78"
,28/10/2022,Receipt,13027,HH Sheikh Mohammed Al-Sharqi:470 RB set of 8 18807,Cash Deposit Receipt for CampusX .470 Ancient set of 8 S/N 18807,Receivables,"30,000.00","2,009,687.78"
,28/10/2022,Receipt,13024,HH Sheikh Mohammed Al-Sharqi:.350 RB set of 8 18804,Cash Deposit Receipt for CampusX .350 No2 Ancient set of 8 S/N 18804,Receivables,"30,000.00","2,039,687.78"
,28/10/2022,Receipt,13022,HH Sheikh Mohammed Al-Sharqi:The British 6,Cash Deposit Receipt for .275 The British 6 London Bets rifle S/N 7121,Receivables,"20,000.00","2,059,687.78"
,31/10/2022,Ledger Entry,3315,,being  Fund Transfer to C.O.S  s/n14752,-Split-,"-5,250.00","2,054,437.78"
,31/10/2022,Ledger Entry,3315,,being  Fund Transfer to C.O.S  s/n14713,-Split-,"-5,250.00","2,049,187.78"
,31/10/2022,Ledger Entry,3315,,being  Fund Transfer to C.O.S  s/n14712,-Split-,"-5,250.00","2,043,937.78"
,31/10/2022,Ledger Entry,3315,,being  Fund Transfer to C.O.S  s/n14711,-Split-,"-5,250.00","2,038,687.78"
,31/10/2022,Ledger Entry,3315,,being  Fund Transfer to C.O.S  s/n14703,-Split-,"-5,250.00","2,033,437.78"
,31/10/2022,Ledger Entry,3315,,being  Fund Transfer to C.O.S  s/n14702,-Split-,"-5,250.00","2,028,187.78"
,31/10/2022,Ledger Entry,3315,,being  Fund Transfer to C.O.S  s/n14701,-Split-,"-5,250.00","2,022,937.78"
,31/10/2022,Ledger Entry,3315,,being  Fund Transfer to C.O.S  s/n14700,-Split-,"-5,250.00","2,017,687.78"
,31/10/2022,Ledger Entry,3315,,being  Fund Transfer to C.O.S  s/n14670,-Split-,"-5,250.00","2,012,437.78"
,31/10/2022,Ledger Entry,3315,,being  Fund Transfer to C.O.S  s/n14669,-Split-,"-5,250.00","2,007,187.78"
,31/10/2022,Ledger Entry,3315,,being  Fund Transfer to C.O.S  s/n14668,-Split-,"-5,250.00","2,001,937.78"
,31/10/2022,Ledger Entry,3315,,being  Fund Transfer to C.O.S  s/n14667,-Split-,"-5,250.00","1,996,687.78"
,31/10/2022,Ledger Entry,3315,,being  Fund Transfer to C.O.S  s/n14656,-Split-,"-5,250.00","1,991,437.78"
,31/10/2022,Ledger Entry,3315,,being  Fund Transfer to C.O.S  s/n14754,-Split-,"-5,250.00","1,986,187.78"
,31/10/2022,Ledger Entry,3315,,being  Fund Transfer to C.O.S  s/n14288,-Split-,"-5,250.00","1,980,937.78"
,31/10/2022,Ledger Entry,3315,,being  Fund Transfer to C.O.S  s/n14799,-Split-,"-5,250.00","1,975,687.78"
,31/10/2022,Ledger Entry,3316,,LTC released Sheikh Al-Sharqi .375 s/n 18752,-Split-,"-30,000.00","1,945,687.78"
,31/10/2022,Ledger Entry,3315,,being released to p & l s/n 19601,-Split-,"22,500.00","1,968,187.78"
,2/11/2022,Receipt,13044,James Walton,Cash Deposit Receipt for Highland Stalker .275 Ancient S/N 14811,Receivables,"5,000.00","1,973,187.78"
,12/11/2022,Receipt,13066,Corey Knowlton,Second Cash Deposit for London Best .404 Jeff S/N 7106,Receivables,"15,686.39","1,988,874.17"
,17/11/2022,Receipt,13134,Sheikh Salman Bin Ebrahim Al-Khalifa,"Cash Deposit Receipt for 6.5 rifle S/N 14832

Total: £18,378 inc Tax",Receivables,"6,666.67","1,995,540.84"
,30/11/2022,Ledger Entry,3344,,Being Fund Transferred to P&L s/n 7070 Thomas Hill,-Split-,"-10,000.00","1,985,540.84"
,30/11/2022,Ledger Entry,3344,,Being Fund Transferred to P&L s/n 18785 Tarek Mashmoud,-Split-,"-27,395.23","1,958,145.61"
,30/11/2022,Ledger Entry,3344,,Being Fund Transferred to P&L s/n 7250M Modesett,-Split-,"-10,011.50","1,948,134.11"
,30/11/2022,Receipt,13145,David Modesett,"Cash Deposit Receipt for 28 bore CampusX Shorgun S/N 18728

Total Receiptd including 13145: £104,250.00",Receivables,"35,000.00","1,983,134.11"
,30/11/2022,Receipt,13145,David Modesett,"Cash Deposit Receipt for 28 bore CampusX Shorgun S/N 18727

Total Receiptd including 13145: £104,250.00",Receivables,"35,000.00","2,018,134.11"
,30/11/2022,Ledger Entry,3344,,Being LTC Released s/n 18727 Modesett,-Split-,"-40,000.00","1,978,134.11"
,30/11/2022,Ledger Entry,3344,,Being Fund Transferred to P&L s/n 7306M Modesett,-Split-,"-10,011.50","1,968,122.61"
,30/11/2022,Ledger Entry,3344,,Being LTC Released s/n 18728 Modesett,-Split-,"-30,000.00","1,938,122.61"
,30/11/2022,Ledger Entry,3344,,Being Fund Transferred to P&L s/n 14811 James Walton,-Split-,"-5,000.00","1,933,122.61"
,2/12/2022,Receipt,13148,Bob Phillips,".275 Ancient B/A Highland Stalker rifle by John Ancient & Co S/N 14839
Including moderator pack and hexalock 30mm scope rings",Receivables,"7,681.00","1,940,803.61"
,8/12/2022,Receipt,13204,Tommy Salmon,"Cash Deposit Receipt for number 5 of 11 Habitat of Rhino S/N 7119

Total: £48,000.00",Receivables,"13,450.00","1,954,253.61"
,31/12/2022,Ledger Entry,3407,,being Fund Transferred to P&L S/N 7109,-Split-,"-15,000.00","1,939,253.61"
,31/12/2022,Ledger Entry,3407,,being Fund Transferred to P&L S/N 18783,-Split-,"-35,000.00","1,904,253.61"
,31/12/2022,Ledger Entry,3407,,being Fund Transferred to P&L S/N 7110,-Split-,"-15,000.00","1,889,253.61"
,31/12/2022,Ledger Entry,3402,,Cash Deposit adjustment s/n  7065,-Split-,0.1,"1,889,253.71"
,31/12/2022,Ledger Entry,3402,,Cash Deposit adjustment s/n  18785,-Split-,-0.6,"1,889,253.11"
,31/12/2022,Ledger Entry,3402,,Cash Deposit adjustment s/n  7102,-Split-,"1,625.00","1,890,878.11"
,31/12/2022,Ledger Entry,3402,,Sheikh Salman  Cash Deposit adjustment s/n 10859,-Split-,"5,000.00","1,895,878.11"
,31/12/2022,Ledger Entry,3407,,being Fund Transferred to P&L S/N 7101,-Split-,"-30,000.00","1,865,878.11"
,31/12/2022,Ledger Entry,3407,,being Fund Transferred to P&L Ancient Cannon for Sheikh Al-Sharqi,-Split-,"-12,500.00","1,853,378.11"
,31/12/2022,Ledger Entry,3416,,reverse journal number 3315 adjustment s/n 19601,-Split-,"-22,500.00","1,830,878.11"
Total for Orders in Hand/Deferred Income,,,,,,,"£833,259.25  ",
PAYE Tax,,,,,,,,
,Beginning Balance,,,,,,,"47,235.67"
,20/01/2022,Fund Transfer,,,,EastX ****2310,"-47,235.67",0
,26/01/2022,Ledger Entry,2994,,January 2021 staff salary,-Split-,"30,962.62","30,962.62"
,23/02/2022,Fund Transfer,,,,EastX ****2310,"-30,962.62",0
,28/02/2022,Ledger Entry,3037,,Feb 2021 staff wages,-Split-,"29,597.61","29,597.61"
,22/03/2022,Fund Transfer,,,,EastX ****2310,"-29,597.61",0
,29/03/2022,Ledger Entry,3063,,March 2021 salary,-Split-,"30,138.79","30,138.79"
,20/04/2022,Fund Transfer,,,,EastX ****2310,"-30,138.79",0
,29/04/2022,Ledger Entry,3081,,April 2021 wages,-Split-,"32,287.99","32,287.99"
,24/05/2022,Fund Transfer,,,,EastX ****2310,"-19,000.00","13,287.99"
,24/05/2022,Fund Transfer,,,,EastX ****2310,"-13,287.99",0
,31/05/2022,Ledger Entry,3116,,May 2021 Staff wages,-Split-,"31,572.17","31,572.17"
,18/06/2022,Fund Transfer,,,,EastX ****2310,"-31,572.17",0
,25/06/2022,Ledger Entry,3162,,June 2021 salary,-Split-,"51,110.65","51,110.65"
,20/07/2022,Fund Transfer,,,,EastX ****2310,"-40,000.00","11,110.65"
,30/07/2022,Ledger Entry,3193,,July 2021 salary,-Split-,"29,109.02","40,219.67"
,3/8/2022,Ledger Entry,3218,,Corporation tax Refund,-Split-,"-11,110.65","29,109.02"
,17/08/2022,Fund Transfer,,,,EastX ****2310,"-29,109.02",0
,26/08/2022,Ledger Entry,3227,,August 2021staff wages,-Split-,"29,242.48","29,242.48"
,17/09/2022,Fund Transfer,,,,EastX ****2310,"-29,972.84",-730.36
,30/09/2022,Ledger Entry,3255,,September 2021 Gross Salary,-Split-,"36,966.81","36,236.45"
,18/10/2022,Fund Transfer,,,,EastX ****2310,"-36,236.45",0
,31/10/2022,Ledger Entry,3314,,October 2021 salary,-Split-,"29,007.35","29,007.35"
,16/11/2022,Fund Transfer,,,,EastX ****2310,"-29,007.35",0
,30/11/2022,Ledger Entry,3349,,November 2021 Salary,-Split-,"33,733.31","33,733.31"
,20/12/2022,Ledger Entry,3387,,December Salary,-Split-,"64,141.27","97,874.58"
,22/12/2022,Fund Transfer,,,,EastX ****2310,"-33,733.00","64,141.58"
Total for PAYE Tax,,,,,,,"£16,905.91  ",
Pension Payable,,,,,,,,
,Beginning Balance,,,,,,,"4,107.76"
,22/01/2022,Fund Transfer,,,,EastX ****2310,"-4,107.76",0
,26/01/2022,Ledger Entry,2994,,January 2021 staff salary,-Split-,"3,104.94","3,104.94"
,25/02/2022,Fund Transfer,,,,EastX ****2310,"-3,104.94",0
,28/02/2022,Ledger Entry,3037,,Feb 2021 staff wages,-Split-,"3,326.86","3,326.86"
,25/03/2022,Fund Transfer,,,,EastX ****2310,"-3,326.86",0
,29/03/2022,Ledger Entry,3063,,March 2021 salary,-Split-,"3,328.24","3,328.24"
,15/04/2022,Fund Transfer,,,,EastX ****2310,"-3,328.24",0
,29/04/2022,Ledger Entry,3081,,April 2021 wages,-Split-,"3,470.99","3,470.99"
,31/05/2022,Ledger Entry,3116,,May 2021 Staff wages,-Split-,"3,313.07","6,784.06"
,2/6/2022,Fund Transfer,,,,EastX ****2310,"-3,470.99","3,313.07"
,24/06/2022,Fund Transfer,,,,EastX ****2310,"-3,313.07",0
,25/06/2022,Ledger Entry,3162,,June 2021 salary,-Split-,"3,485.49","3,485.49"
,20/07/2022,Fund Transfer,,,,EastX ****2310,"-3,485.49",0
,30/07/2022,Ledger Entry,3193,,July 2021 salary,-Split-,"3,182.98","3,182.98"
,19/08/2022,Fund Transfer,,,,EastX ****2310,"-3,182.98",0
,26/08/2022,Ledger Entry,3227,,August 2021staff wages,-Split-,"3,210.26","3,210.26"
,27/09/2022,Fund Transfer,,,,EastX ****2310,"-3,210.26",0
,30/09/2022,Ledger Entry,3255,,September 2021 Gross Salary,-Split-,"3,169.08","3,169.08"
,21/10/2022,Fund Transfer,,,,EastX ****2310,"-3,169.08",0
,31/10/2022,Ledger Entry,3314,,October 2021 salary,-Split-,"3,424.79","3,424.79"
,30/11/2022,Ledger Entry,3349,,November 2021 Salary,-Split-,"3,772.90","7,197.69"
,1/12/2022,Fund Transfer,,,,EastX ****2310,"-3,424.79","3,772.90"
,20/12/2022,Ledger Entry,3387,,December Salary,-Split-,"4,363.18","8,136.08"
,21/12/2022,Fund Transfer,,,,EastX ****2310,"-3,772.90","4,363.18"
Total for Pension Payable,,,,,,,£255.42  ,
Tax Control,,,,,,,,
,Beginning Balance,,,,,,,"-64,480.74"
,1/1/2022,Expense,201817,Debbie Thomas,,Payables,0,"-64,480.74"
,1/1/2022,Vendor Credit,,West London Shooting School,,Payables,28.14,"-64,452.60"
,1/1/2022,Expense,16776,GWT Media,,Payables,-33.9,"-64,486.50"
,1/1/2022,Expense,2700,Julian & Sons,,Payables,0,"-64,486.50"
,1/1/2022,Expense,2522,Arms Restoration Services,,Payables,"-1,410.00","-65,896.50"
,1/1/2022,Expense,201817,Debbie Thomas,,Payables,0,"-65,896.50"
,2/1/2022,Expense,,Jamie,,Payables,-41.23,"-65,937.73"
,2/1/2022,Expense,10025,SNT Adventure Brands LLC,,Payables,0,"-65,937.73"
,4/1/2022,Bank Draft,Mary1223,guntrader.co.uk,,EastX ****2310,-2.9,"-65,940.63"
,4/1/2022,Receipt,12066,Gut Grambow SonySports GmbH,,Receivables,0,"-65,940.63"
,4/1/2022,Receipt,12064,Online Sale,,Receivables,35.17,"-65,905.46"
,4/1/2022,Ledger Entry,2990,,,-Split-,0,"-65,905.46"
,4/1/2022,Receipt,12067,David Austin,,Receivables,0,"-65,905.46"
,4/1/2022,Receipt,12068,Online Sale,,Receivables,0,"-65,905.46"
,5/1/2022,Bank Draft,9260,Castle Water,,EastX Bank,-9.88,"-65,915.34"
,5/1/2022,Expense,156673,Hull Cartridge Company Limited,,Payables,-5.04,"-65,920.38"
,5/1/2022,Expense,14609,Northwood Group UK Vendor,,Payables,"-1,860.00","-67,780.38"
,5/1/2022,Bank Draft,Mary1225,eon,,EastX ****2310,-9.11,"-67,789.49"
,31/12/2022,Bank Draft,1568,,,Business Card,-2.41,"-44,775.88"
,31/12/2022,Bank Draft,Mary2187,Aerial Direct,,EastX ****2310,-26.39,"-44,802.27"
,31/12/2022,Bank Draft,1603,,,Business Card,-18.51,"-44,820.78"
,31/12/2022,Bank Draft,1599,,,Business Card,-0.5,"-44,821.28"
,31/12/2022,Bank Draft,1584,,,Business Card,-5.37,"-44,826.65"
,31/12/2022,Bank Draft,1580,,,Business Card,-17.27,"-44,843.92"
,31/12/2022,Bank Draft,1625,,,Business Card,-6.63,"-44,850.55"
,31/12/2022,Bank Draft,1628,,,Business Card,-1.83,"-44,852.38"
,31/12/2022,Bank Draft,,,,Business Card,-4.95,"-44,857.33"
,31/12/2022,Bank Draft,1612,,,Business Card,-7.62,"-44,864.95"
,31/12/2022,Bank Draft,1597,,,Business Card,-19.35,"-44,884.30"
,31/12/2022,Bank Draft,1587,,,Business Card,-0.83,"-44,885.13"
Total for Tax Control,,,,,,,"£19,595.61  ",
Tax Suspense,,,,,,,,
,Beginning Balance,,,,,,,28.7
,8/3/2022,Ledger Entry,,,Filed Tax,-Split-,"-79,600.83","-79,572.13"
,29/03/2022,Tax Transaction,,,,-Split-,"79,600.83",28.7
,7/6/2022,Ledger Entry,,,Filed Tax,-Split-,"-53,026.10","-52,997.40"
,16/06/2022,Tax Transaction,,,,-Split-,"53,026.10",28.7
,1/9/2022,Ledger Entry,,,Filed Tax,-Split-,"-88,261.25","-88,232.55"
,10/9/2022,Tax Transaction,,,,-Split-,"88,261.25",28.7
,1/12/2022,Ledger Entry,,,Filed Tax,-Split-,"-84,686.88","-84,658.18"
,13/12/2022,Tax Transaction,,,,-Split-,"84,686.88",28.7
Total for Tax Suspense,,,,,,,£0.00  ,
Northwood Group Loan,,,,,,,,
,Beginning Balance,,,,,,,"2,345,000.00"
,25/05/2022,Ledger Entry,3120,,Shor term loan from Northwood Group,-Split-,"100,000.00","2,445,000.00"
,26/05/2022,Ledger Entry,3121,,ReTransaction of short term loan,-Split-,"-100,000.00","2,345,000.00"
,18/06/2022,Ledger Entry,3169,,Loan from Northwood to pay dividend,-Split-,"500,000.00","2,845,000.00"
Total for Northwood Group Loan,,,,,,,"£500,000.00  ",
Northwood Loan,,,,,,,,
,29/07/2022,Ledger Entry,3190,,Short term loan,-Split-,"100,000.00","100,000.00"
,30/07/2022,Ledger Entry,3191,,Short term loan reTransaction,-Split-,"-100,000.00",0
Total for Northwood Loan,,,,,,,£0.00  ,
Dividend,,,,,,,,
,Beginning Balance,,,,,,,"-175,000.00"
,21/06/2022,Ledger Entry,3170,,Dividend paid Northwood Group,-Split-,"-400,000.00","-575,000.00"
,21/06/2022,Ledger Entry,3170,,Dividend paid to Marc Newton,-Split-,"-100,000.00","-675,000.00"
Total for Dividend,,,,,,,"-£500,000.00  ",
Retained Earnings,,,,,,,,
,Beginning Balance,,,,,,,"983,568.13"
Total for Retained Earnings,,,,,,,,
Share Capital,,,,,,,,
,Beginning Balance,,,,,,,"5,000.00"
Total for Share Capital,,,,,,,,
Discounts given,,,,,,,,
,2/8/2022,Receipt,12751,SAS Hunting Club Consulting,Discount,Receivables,-29.1,-29.1
,2/8/2022,Receipt,12752,EBN Hunting,Discount,Receivables,-119.4,-148.5
,28/10/2022,Receipt,13032,Outdoor Outfitters,Discount,Receivables,"-45,045.60","-45,194.10"
Total for Discounts given,,,,,,,"-£45,194.10  ",
Dividend Income,,,,,,,,
,4/11/2022,Ledger Entry,3330,,Dividend received from TEG,-Split-,"24,800.00","24,800.00"
,4/11/2022,Ledger Entry,3330,,Dividend received from TEG,-Split-,"24,800.00","49,600.00"
Total for Dividend Income,,,,,,,"£49,600.00  ",
Sales of Product Income,,,,,,,,
   Non UK Sales,,,,,,,,
,4/1/2022,Receipt,12067,David Austin,"Higland Stalker poster V1, V2 and V3",Receivables,9,9
,4/1/2022,Receipt,12068,Online Sale,10278,Receivables,358.33,367.33
,4/1/2022,Receipt,12066,Gut Grambow SonySports GmbH,Shipping,Receivables,20,387.33
,4/1/2022,Receipt,12066,Gut Grambow SonySports GmbH,Apron,Receivables,45,432.33
,4/1/2022,Receipt,12066,Gut Grambow SonySports GmbH,Safari Jacket 42,Receivables,320,752.33
,4/1/2022,Ledger Entry,2990,,Web sale refund order 10278,-Split-,-211,541.33
,5/1/2022,Receipt,12070,Northwood USA 1,Shipping,Receivables,20,561.33
,5/1/2022,Receipt,12070,Northwood USA 1,Closed bullet pouch magnum x 4,Receivables,300,861.33
,5/1/2022,Receipt,12070,Northwood USA 1,Closed bullet pouch european x 4,Receivables,300,"1,161.33"
,5/1/2022,Receipt,12069,Online Sale,10283,Receivables,379.17,"1,540.50"
,6/1/2022,Receipt,12072,Online Sale,10285,Receivables,125,"1,665.50"
,7/1/2022,Receipt,12076,SHOP SALE,replacement corbett books for website order,Receivables,0,"1,665.50"
,7/1/2022,Receipt,12075,Online Sale,10288,Receivables,106.67,"1,772.17"
,11/1/2022,Receipt,12080,Online Sale,order 10291,Receivables,115,"1,887.17"
,11/1/2022,Receipt,12079,Online Sale,order 10290,Receivables,239,"2,126.17"
,11/1/2022,Receipt,12082,Online Sale,order 10293,Receivables,55,"2,181.17"
,12/1/2022,Receipt,12086,David Austin,Ancient face mask,Receivables,24,"2,205.17"
,12/1/2022,Receipt,12085,Online Sale,10296,Receivables,106.67,"2,311.84"
,12/1/2022,Receipt,12084,Online Sale,10295,Receivables,160,"2,471.84"
,12/1/2022,Receipt,12087,Ifzaal  Musa,"Shipping, freight, export documentation, customs, airline handling, cartage and packing: 14661, 14663 and 14640",Receivables,"1,350.00","3,821.84"
,13/01/2022,Receipt,12091,Online Sale,10299,Receivables,295.83,"4,117.67"
,13/01/2022,Receipt,12089,Online Sale,order 10297,Receivables,212.5,"4,330.17"
,13/01/2022,Receipt,12092,Northwood USA 1,Leather wine glass carrier,Receivables,315,"4,645.17"
,13/01/2022,Receipt,12092,Northwood USA 1,Leather fieldbar,Receivables,585,"5,230.17"
,13/01/2022,Receipt,12092,Northwood USA 1,Leather money clip,Receivables,180,"5,410.17"
,13/01/2022,Receipt,12092,Northwood USA 1,Leather wallet,Receivables,140,"5,550.17"
,13/01/2022,Receipt,12092,Northwood USA 1,Leather bracelet,Receivables,10,"5,560.17"
,13/01/2022,Receipt,12092,Northwood USA 1,Poster A3 v1,Receivables,6,"5,566.17"
,13/01/2022,Receipt,12092,Northwood USA 1,Poster A3 v2,Receivables,6,"5,572.17"
,13/01/2022,Receipt,12092,Northwood USA 1,Poster A3 v3,Receivables,6,"5,578.17"
,13/01/2022,Receipt,12092,Northwood USA 1,Poster Keep Calm,Receivables,6,"5,584.17"
,31/12/2022,Ledger Entry,3402,,Cash Deposit adjustment s/n  7102,-Split-,"-1,625.00","3,655,595.48"
,31/12/2022,Ledger Entry,3407,,being Fund Transferred to P&L S/N 18783,-Split-,"35,000.00","3,690,595.48"
   Total for Non UK Sales,,,,,,,"£3,690,595.48  ",
   Sales,,,,,,,,
,8/2/2022,Receipt,12140,Vere Harmsworth,"Repair work to 270 H&H 270 Win rifle
Action bedding, adjusting of scope mounts and test shooting",Receivables,340,340
,30/03/2022,Receipt,12269,Viscount John  Massereene & Ferrard,Replace broken cocking limb to Lang Shotgun No 16279,Receivables,375,715
,19/04/2022,Receipt,12313,Northwood Group UK,Fitting new bipod adaptors to forend,Receivables,67.5,782.5
,19/04/2022,Receipt,12313,Northwood Group UK,Fitting new bipod adaptors to forend,Receivables,67.5,850
,21/04/2022,Receipt,12321,The Traditional English cases Ltd,Insurance Transaction on behalf of TEG,Receivables,77.39,927.39
,22/04/2022,Receipt,12333,Nigel Gillman,".275 Ancient B/A rifle S/N 2025

Set of EAW scope mounts
Fit the mounts and test shoot/ zero the rifle
Strip and clean",Receivables,780,"1,707.39"
,23/04/2022,Receipt,12383,The Traditional English cases Ltd,Insurance Transaction on behalf of TEG Willis Towers,Receivables,214.26,"1,921.65"
,29/04/2022,Receipt,12365,HH Sheikh Mohammed Al-Sharqi,"Repair 12 bore shotgun S/N 18013
Rejointing barrel and spare set  11.5 hours
Restoring and refinishing stock and fitting new ovals  4 hours
Strip and clean  1.25 hours
Engraving new oval  1 hour",Receivables,"1,487.50","3,409.15"
,29/04/2022,Receipt,12366,HH Sheikh Mohammed Al-Sharqi,"Repair 12 bore shotgun S/N 18012
Strip and clean  1.5 hours
Rejointing  3.5 hours
Restoring and refinishing stock and fitting new ovals  4 hours 
Engraving new oval  1 hour",Receivables,850,"4,259.15"
,4/5/2022,Receipt,12375,Northwood Group UK,"Fitting engraved pistol grip plate into stock 
For rifle SN: R/216946, stock no. RR074778",Receivables,180,"4,439.15"
,10/5/2022,Receipt,12394,Adam Kelliher,Fitting bipod stud,Receivables,170,"4,609.15"
,18/05/2022,Receipt,12411,Northwood Group UK,"Aligning forend tip 
45 minutes",Receivables,33.75,"4,642.90"
,18/05/2022,Receipt,12411,Northwood Group UK,Fitting Harris Bipod Stud,Receivables,90,"4,732.90"
,18/05/2022,Receipt,12417,The Hon Charles Pearson,"Repair .270 B/A rifle 6681

Re-crown the barrel
Adjust the trigger
Regulate at the range
Zeroed at the range",Receivables,788.65,"5,521.55"
,24/05/2022,Receipt,12441,Northwood Group UK,Open up barrel channel to 19mm for stock no. RR069506,Receivables,135,"5,656.55"
,31/05/2022,Receipt,12455,Jillo Waddington,"Repair 20b Boss & co O/U shotgun

Restocked the gun
Fitted new oval
Fixed single trigger mechanism",Receivables,"13,000.00","18,656.55"
,11/6/2022,Receipt,12495,Charles Lesser,"Joseph Lang 12b S/N 8195
Strip and clean",Receivables,127.5,"18,784.05"
,11/6/2022,Receipt,12495,Charles Lesser,Replace left side main spring,Receivables,170,"18,954.05"
,17/06/2022,Receipt,12515,Nikolai Vladislavovich Gurianov,"Ammunition used in testing:
5 rounds of Hornady 180 gr .308 Win 
23 rounds of Norma 180 gr .308 Win 
10 rounds of Federal 180 gr .308 Win",Receivables,66.67,"19,020.72"
,17/06/2022,Receipt,12515,Nikolai Vladislavovich Gurianov,"J Purdey & Sons .308 Win SN:30191
Repair work:
Re-Crown and correct bedding,
Correct trigger pull, polish and re-black rear sight
Adjust Smithson scope mount
Shoot and test at range 

Special price (normally £85 + Tax per hour)",Receivables,350,"19,370.72"
,12/7/2022,Receipt,12579,Mr Roger Karlsson,Repair broken stock for 20g Browning B25,Receivables,180,"19,550.72"
,8/10/2022,Receipt,12947,Charles Lazenby,strip and clean AYA shotgun S/N 461-08 and fit new spring,Receivables,275,"19,825.72"
,14/10/2022,Receipt,12959,Lord Charles Aldington,"Repair work to a 20-bore Webley & Scott, no. 99508",Receivables,270.83,"20,096.55"
,18/10/2022,Receipt,12971,Huw Thomas,strip and clean gallyan and son 11298 12 bore,Receivables,166.67,"20,263.22"
,19/10/2022,Receipt,12973,Simon Calcutt,extension on westley richards,Receivables,150,"20,413.22"
,22/10/2022,Receipt,12992,John Pelly,Repair work S/N 5371,Receivables,583.33,"20,996.55"
,28/10/2022,Receipt,13033,Steven F Clark,"Re-barrel  including sourcing new barrel from Lothar Walther, fitting of front and rear sight, fitting sling swivel, actioning and chambering for London Proof
Re stocking forend, making and fitting take down mechanism
Re finishing stock, Bank Draftring forend and refreshing stocks Bank Draftring
Engraving on barrel
Blacking of barrel
Shooting and regulating with 175gr ammunition",Receivables,"13,231.00","34,227.55"
,29/10/2022,Receipt,13017,Northwood Group UK,Refinishing Northwood F16 FGR011831 (FG/013582) and FGR011830 (FG/013107),Receivables,900,"35,127.55"
,3/11/2022,Receipt,13064,SHOP SALE,fit scope in Northwood R8,Receivables,62.5,"35,190.05"
,10/11/2022,Receipt,13153,SHOP SALE,repair CampusX 12 bore 16328,Receivables,333.33,"35,523.38"
,10/11/2022,Receipt,13060,Alfie Southwell,barrel blacking,Receivables,208.33,"35,731.71"
,12/11/2022,Receipt,13068,SHOP SALE,repair pin stock aya 569663,Receivables,500,"36,231.71"
,12/11/2022,Receipt,13065,SHOP SALE,new sprinf to J Blanch 5540,Receivables,208.33,"36,440.04"
,15/11/2022,Receipt,13077,Andrew Parsons,fit new moderator to 14142,Receivables,555.83,"36,995.87"
,24/11/2022,Receipt,13105,Davis Peterson,Strip and clean and service,Receivables,800,"37,795.87"
,15/12/2022,Receipt,13183,Steven F Clark,"Re-barrel  including sourcing new barrel from Lothar Walther, fitting of front and rear sight, fitting sling swivel, actioning and chambering for London Proof
Re stocking forend, making and fitting take down mechanism
Re finishing stock, Bank Draftring forend and refreshing stocks Bank Draftring
Engraving on barrel
Blacking of barrel
Shooting and regulating with 175gr ammunition

Total price of repair work: £12,000
Prepaid: £5,080",Receivables,"6,940.00","44,735.87"
,15/12/2022,Debit Memo,13182,Steven F Clark,"Re-barrel  including sourcing new barrel from Lothar Walther, fitting of front and rear sight, fitting sling swivel, actioning and chambering for London Proof
Re stocking forend, making and fitting take down mechanism
Re finishing stock, Bank Draftring forend and refreshing stocks Bank Draftring
Engraving on barrel
Blacking of barrel
Shooting and regulating with 175gr ammunition",Receivables,"-13,231.00","31,504.87"
,24/12/2022,Receipt,13175,Northwood Group UK,opening out R8 stock with number RR068925,Receivables,70,"31,574.87"
   Total for Sales,,,,,,,"£31,574.87  ",
   UK Sales,,,,,,,,
,4/1/2022,Receipt,12064,Online Sale,10276,Receivables,175.83,175.83
,6/1/2022,Receipt,12071,Online Sale,10284,Receivables,80,255.83
,7/1/2022,Receipt,12074,Online Sale,10287,Receivables,310,565.83
,7/1/2022,Receipt,12077,SHOP SALE,shipping,Receivables,16.67,582.5
,7/1/2022,Receipt,12077,SHOP SALE,Set of corbett books,Receivables,199,781.5
,11/1/2022,Receipt,12083,Online Sale,order 10294,Receivables,68.33,849.83
,11/1/2022,Receipt,12081,Online Sale,order 10292,Receivables,92.5,942.33
,13/01/2022,Receipt,12090,Online Sale,order 10298,Receivables,43.33,985.66
,19/01/2022,Receipt,12104,Online Sale,10312 shipping,Receivables,10,995.66
,19/01/2022,Receipt,12104,Online Sale,10312 (a grand tradition book),Receivables,29,"1,024.66"
,23/12/2022,Receipt,13209,Online Sale,11602,Receivables,110,"164,425.90"
,25/12/2022,Receipt,13215,Online Sale,11606,Receivables,114.17,"164,540.07"
,27/12/2022,Receipt,13229,Bertrand  Batoux,whisky,Receivables,66,"164,606.07"
   Total for UK Sales,,,,,,,"£164,606.07  ",
Total for Sales of Product Income,,,,,,,"£3,886,776.42  ",
Commission,,,,,,,,
,19/04/2022,Expense,,G Duffey,Commission for selling rifles,Payables,"3,561.99","3,561.99"
,31/05/2022,Expense,,Gordy& Son,"Commission for David Modesett s/n 18727 & 18728 (£120,000)",Payables,"24,000.00","27,561.99"
,13/09/2022,Expense,259,Forest Italia,"commission on HS Bell Lugli - 4,310 Eur",Payables,"3,684.00","31,245.99"
,1/11/2022,Expense,PBkk 20-39,"Le Arms, LLC","10% on Sale £27,950 to Mr T.H. Shaffer",Payables,"2,810.00","34,055.99"
,22/11/2022,Expense,,Andrew Ambrose,2% commission for various rifles from 12/10/2018 to 29/10/2019,Payables,"4,317.80","38,373.79"
Total for Commission,,,,,,,"£38,373.79  ",
Cost of sales,,,,,,,,
,1/1/2022,Expense,2700,Julian & Sons,December and January,Payables,616.34,616.34
,5/1/2022,Expense,14609,Northwood Group UK Vendor,Fluting surcharge,Payables,436,"1,052.34"
,5/1/2022,Expense,14609,Northwood Group UK Vendor,Grade 9 wood upgrade wood upgrade,Payables,938,"1,990.34"
,5/1/2022,Expense,156673,Hull Cartridge Company Limited,Cartridge,Payables,25.19,"2,015.53"
,5/1/2022,Expense,14610,Northwood Group UK Vendor,"Sauer 404 Silence Cal. 300 Win Mag
Fully moderated barrel [17mm] - 520mm
M15x1 - NOS
Right hand
Roe W/ English Scroll Engraving",Payables,"4,647.00","6,662.53"
,5/1/2022,Expense,14609,Northwood Group UK Vendor,"Sauer 404 Avantgarde Grand Lux Cal. 270
Std Fluted Barrel [17mm] - 560mm
M15x1 - NOS
Right hand
Roe W/ English Scroll Engraving",Payables,"7,926.00","14,588.53"
,6/1/2022,Expense,134,Fox & Co Bespokw Ltd,Laser Engraving,Payables,140,"14,728.53"
,12/1/2022,Expense,21200914,Swarovski Optik,300 Win Mag Northwood R8 Silence  for Sheikh Salmans,Payables,"1,737.75","16,466.28"
,13/01/2022,Expense,24292,British Sporting Arms Ltd,"Engrave - BSA Millbrook NY, Geoffroy Gournet PA - $150",Payables,145.01,"16,611.29"
,22/01/2022,Expense,,Laser Welding Services,"1off Bolt to attach new Lever, as per jig/instructions",Payables,210,"16,821.29"
,25/01/2022,Expense,600474,Traditional English Guncases Ltd,"Oak and Leather Case with Camel Leather for .416 No 2
CampusX Rigle with fitted accessories and
canvas outer to match s/n 18744",Payables,"3,750.00","20,571.29"
,26/01/2022,Expense,,Steve Helsley,serial number check,Payables,656,"21,227.29"
,26/01/2022,Expense,,Traditional English Guncases Ltd,M/C Overcase to replace damaged one - for SN 7080,Payables,360,"21,587.29"
,27/01/2022,Vendor Credit,,Kahles,3% bonus,Payables,-26.44,"21,560.85"
,31/01/2022,Ledger Entry,3014,,S2M1FT0332,-Split-,17.4,"21,578.25"
,31/01/2022,Ledger Entry,3014,,S2M1FT0346,-Split-,1.08,"21,579.33"
,31/01/2022,Ledger Entry,3014,,S2M1FT0313,-Split-,15.2,"21,594.53"
,31/01/2022,Ledger Entry,3014,,S2M1FT0331,-Split-,33.36,"21,627.89"
,31/01/2022,Ledger Entry,3014,,S2M1FT1689,-Split-,417,"22,044.89"
,31/01/2022,Ledger Entry,3014,,Ancient sound moderator,-Split-,110,"22,154.89"
,31/01/2022,Ledger Entry,3014,,S2M1FT0332,-Split-,17.4,"22,172.29"
,31/01/2022,Ledger Entry,3014,,S2M1FT0346,-Split-,1.08,"22,173.37"
,31/01/2022,Ledger Entry,3014,,S2M1FT0285,-Split-,11.62,"22,184.99"
,31/01/2022,Ledger Entry,3014,,S2M1FT0288,-Split-,11.62,"22,196.61"
,31/01/2022,Ledger Entry,3014,,S2M1FT0234,-Split-,12.42,"22,209.03"
,31/01/2022,Ledger Entry,3014,,S2M1FT0331,-Split-,33.36,"22,242.39"
,31/01/2022,Ledger Entry,3015,,Being released to P&L,-Split-,"62,623.64","84,866.03"
,31/01/2022,Ledger Entry,3015,,Being released to P&L,-Split-,"6,447.75","91,313.78"
,31/01/2022,Ledger Entry,3018,,Harper office Packing Material  Jan 2021,-Split-,225.62,"91,539.40"
,31/01/2022,Ledger Entry,3015,,Being released to P&L,-Split-,"1,500.00","93,039.40"
,1/2/2022,Expense,41.2,T & D O'Neill,Transport,Payables,105,"93,144.40"
,1/2/2022,Expense,41.2,T & D O'Neill,Transport,Payables,105,"93,249.40"
,1/2/2022,Expense,74979,Kerast,Nitride - warranty,Payables,575,"93,824.40"
,1/2/2022,Expense,74978,Kerast,Hardness testing - warranty,Payables,97,"93,921.40"
,4/2/2022,Expense,2021-A-329,Negrini,Val. P.P. iniez. NERO Vuota mm 1305x325x130  - 747.87 Eur,Payables,685.67,"94,607.07"
,8/2/2022,Expense,600488,Traditional English Guncases Ltd,Special Edition blue canvas case for Big Game Riffle. Keep Calm edition. (SN 11060 released for COS),Payables,850,"95,457.07"
,9/2/2022,Expense,220,Johnsons & Co Ltd,Best Black,Payables,"1,750.00","97,207.07"
,9/2/2022,Expense,2.10E+13,Raytrade UK Ltd,Spartan Classic Gunsmith Adapter Brass & Dirt Plug,Payables,22,"97,229.07"
,9/2/2022,Expense,2.10E+13,Raytrade UK Ltd,Spartan ProHunt Bipod - Standard Length,Payables,179,"97,408.07"
,10/2/2022,Expense,23,BF&D LIMITED,engraving bolt action rifle,Payables,"1,200.00","98,608.07"
,15/02/2022,Expense,Proforma,The Birmingham Gun Barrel Proof House,Catridge test,Payables,750,"99,358.07"
,15/02/2022,Expense,341,IPS Gunmaking Ltd,Bank Draftr bolt action,Payables,300,"99,658.07"
,16/02/2022,Expense,2.10E+13,Raytrade UK Ltd,Spartan Classic Gunsmith Adapter Brass & Dirt Plug,Payables,44,"99,702.07"
,21/02/2022,Expense,1289,John Whitfield,"Studio Photography - 3 Feb 21, retouching and cut out",Payables,800,"100,502.07"
,22/02/2022,Bank Draft,Mary1353,Wbc,Netlon Stretchable Protective Sleeve (300 units),EastX ****2310,40.25,"100,542.32"
,22/02/2022,Expense,48,Ray St Ledger & Sons,No 18744,Payables,40,"100,582.32"
,22/02/2022,Expense,600494,Traditional English Guncases Ltd,Supplied Americases fitted out to specification,Payables,"1,500.00","102,082.32"
,24/02/2022,Expense,1656,TimberLake Workshop,Data set up fee,Payables,30,"102,112.32"
,24/02/2022,Expense,44207,The Company of Gunmakers,.416 Ancient B/A RIFLE INSTANT PROOF,Payables,67.13,"102,179.45"
,24/02/2022,Expense,44207,The Company of Gunmakers,Deep Engraving,Payables,10,"102,189.45"
,24/02/2022,Expense,1656,TimberLake Workshop,"Import mark, EU spec mark",Payables,30,"102,219.45"
,26/02/2022,Expense,75064,Kerast,Hardness testing - warranty,Payables,145.5,"102,364.95"
,28/02/2022,Ledger Entry,3036,,S2M1FT1947,-Split-,6,"102,370.95"
,28/02/2022,Ledger Entry,3036,,S2M1FT0221,-Split-,2.49,"102,373.44"
,28/02/2022,Ledger Entry,3036,,S2M1FT1495,-Split-,12.41,"102,385.85"
,28/02/2022,Ledger Entry,3036,,S2M1FT0235,-Split-,12.41,"102,398.26"
,28/02/2022,Ledger Entry,3036,,S2M1FT1776,-Split-,3,"102,401.26"
,28/02/2022,Ledger Entry,3036,,S2M1FT0205,-Split-,60.07,"102,461.33"
,28/02/2022,Ledger Entry,3036,,S2M1FT0205,-Split-,60.07,"102,521.40"
,28/02/2022,Ledger Entry,3036,,S2M1FT0273,-Split-,2,"102,523.40"
,28/02/2022,Ledger Entry,3036,,S2M1FT0941,-Split-,2,"102,525.40"
,28/02/2022,Ledger Entry,3036,,S2M1FT0184,-Split-,38.51,"102,563.91"
,28/02/2022,Ledger Entry,3036,,S2M1FT0185,-Split-,31.94,"102,595.85"
,28/02/2022,Ledger Entry,3036,,S2M1FT0217,-Split-,34.79,"102,630.64"
,28/02/2022,Ledger Entry,3036,,S2M1FT0218,-Split-,56.28,"102,686.92"
,28/02/2022,Ledger Entry,3036,,S2M1FT0337,-Split-,112.58,"102,799.50"
,28/02/2022,Ledger Entry,3036,,S2M1FT0300,-Split-,2,"102,801.50"
,28/02/2022,Ledger Entry,3046,,Harper office Packing Material  Feb 2021,-Split-,225.62,"103,027.12"
,28/02/2022,Ledger Entry,3045,,Being released to P&L s/n 7375M,-Split-,"29,854.31","132,881.43"
,28/02/2022,Ledger Entry,3045,,Being Fund Transfer to cost of sale accessories stock,-Split-,"3,947.45","136,828.88"
,28/02/2022,Ledger Entry,3036,,S2M1FT0234,-Split-,12.41,"136,841.29"
,28/02/2022,Bank Draft,791,,BrandCo branding Limited,Business Card,318.19,"137,159.48"
,1/3/2022,Expense,144,Fox & Co Bespokw Ltd,Laser Engraving,Payables,160,"137,319.48"
,1/3/2022,Expense,11902,J Roberts & Son Ltd,250 Lyalvale 12 bore fibre 28gr No 5,Payables,65,"137,384.48"
,1/3/2022,Expense,11902,J Roberts & Son Ltd,250 RC Sipe Extreme fibre 30gr No 5,Payables,80,"137,464.48"
,1/3/2022,Expense,695228,Jay Spark Co Ltd,Gun components,Payables,76.54,"137,541.02"
,1/3/2022,Bank Draft,Mary1366,guntrader.co.uk,,EastX ****2310,14.5,"137,555.52"
,1/3/2022,Expense,1284,Broadbent Leather goods,Ancient Hunting Journal in navy cloth,Payables,47,"137,602.52"
,1/3/2022,Expense,1322,Broadbent Leather goods,Shooting book in brown croc-print leather,Payables,78.75,"137,681.27"
,1/3/2022,Expense,695537,Jay Spark Co Ltd,Gun components,Payables,24.02,"137,705.29"
,3/3/2022,Expense,1001/00074283,Edgar Brothers,.30-06 Sprg 165gr SST SPF (20/200),Payables,123.53,"137,828.82"
,3/3/2022,Expense,1001/00074283,Edgar Brothers,.375 H&H Mag 300gr DGS Dangerous Game,Payables,269,"138,097.82"
,3/3/2022,Expense,1739,A T Miles,Scope rings white gold inlay front J Ancient & Co rear Cal 416 Ancient,Payables,280,"138,377.82"
,3/3/2022,Expense,1001/00074283,Edgar Brothers,.375 H&H Mag 300gr DGX Bonded Dangerous game,Payables,279.24,"138,657.06"
,8/3/2022,Expense,9501,The Print Factory,Ancient A$ target,Payables,595,"139,252.06"
,9/3/2022,Expense,44229,The Company of Gunmakers,Special engraving,Payables,10,"139,262.06"
,11/3/2022,Expense,1001/00074827,Edgar Brothers,.243 Win 95gr SST SPF,Payables,"1,035.90","140,297.96"
,12/3/2022,Expense,24426,British Sporting Arms Ltd,"Shipping cost, export fees - $6,365",Payables,"4,700.65","144,998.61"
,17/03/2022,Expense,OP/I763517,GMK,SLING SWIVEL PAIR STANDARD,Payables,24,"145,022.61"
,17/03/2022,Expense,OP/I763517,GMK,SAKO RIFLE SLING,Payables,30,"145,052.61"
,17/03/2022,Expense,OP/I763517,GMK,SAKO BASE BLUE ACTIONS I & III XS S,Payables,31,"145,083.61"
,17/03/2022,Expense,OP/I763517,GMK,SAKO/TIKKA RING BLUE 30MM MEDIUM,Payables,54,"145,137.61"
,18/03/2022,Expense,OP/I1763624,GMK,85 S HUNTER WOOD BLUE .243 REM 20IN MT 14X1 LH,Payables,"1,215.00","146,352.61"
,25/03/2022,Ledger Entry,3061,,S2M1FT1421,-Split-,1.9,"146,354.51"
,25/03/2022,Ledger Entry,3061,,S2M1FT0220,-Split-,42.74,"146,397.25"
,25/03/2022,Ledger Entry,3061,,S2M1FT0418,-Split-,25,"146,422.25"
,25/03/2022,Ledger Entry,3061,,S2M1FT1801,-Split-,69.89,"146,492.14"
,25/03/2022,Ledger Entry,3061,,S2M1FT1497,-Split-,149.5,"146,641.64"
,25/03/2022,Ledger Entry,3061,,S2M1FT0943,-Split-,0,"146,641.64"
,25/03/2022,Ledger Entry,3061,,S2M1FT0187,-Split-,27.5,"146,669.14"
,25/03/2022,Ledger Entry,3061,,S2M1FT0346,-Split-,1.08,"146,670.22"
,25/03/2022,Ledger Entry,3061,,S2M1FT0332,-Split-,8.7,"146,678.92"
,25/03/2022,Ledger Entry,3061,,S2M1FT1421,-Split-,1.9,"146,680.82"
,25/03/2022,Ledger Entry,3061,,S2M1FT0207,-Split-,16.97,"146,697.79"
,25/03/2022,Ledger Entry,3061,,S2M1FT0942,-Split-,2,"146,699.79"
,25/03/2022,Ledger Entry,3061,,S2M1FT0178,-Split-,46.7,"146,746.49"
,25/03/2022,Ledger Entry,3061,,S2M1FT0300,-Split-,2,"146,748.49"
,30/03/2022,Expense,102606,SRS Freight Ltd,shipping guns to Northwood USA,Payables,"2,712.50","149,460.99"
,31/03/2022,Bank Draft,861,,Oil colour,Business Card,43.22,"149,504.21"
,31/03/2022,Bank Draft,818,,Packing tape,Business Card,44,"149,548.21"
,31/03/2022,Bank Draft,848,,Oil Lamp,Business Card,39.5,"149,587.71"
,31/03/2022,Ledger Entry,3071,,Being released to P & L from WIP,-Split-,"59,772.35","209,360.06"
,31/03/2022,Ledger Entry,3071,,Being released to P & L from WIP,-Split-,"9,578.14","218,938.20"
,31/03/2022,Ledger Entry,3069,,Cookson Gold refund,-Split-,-686.33,"218,251.87"
,31/03/2022,Bank Draft,862,,OPil painting,Business Card,16.62,"218,268.49"
,31/03/2022,Expense,698327,Jay Spark Co Ltd,Rifle rod .270,Payables,10.22,"218,278.71"
,31/03/2022,Ledger Entry,3072,,Harper office Packing Material  March 2021,-Split-,225.62,"218,504.33"
,1/4/2022,Expense,600483,Traditional English Guncases Ltd,Full lenght rifle case for Nile Edition,Payables,"1,500.00","220,004.33"
,1/4/2022,Expense,698055,Jay Spark Co Ltd,Tools,Payables,90.13,"220,094.46"
,1/4/2022,Expense,600506,Traditional English Guncases Ltd,Full length Rifle Case for Nile Edition B/A Rifle - 4,Payables,"6,000.00","226,094.46"
,1/4/2022,Expense,,Kerast,Vacuum annealed,Payables,175,"226,269.46"
,1/4/2022,Expense,,Kerast,Postage,Payables,20,"226,289.46"
,1/4/2022,Expense,75272,Kerast,Hardness testing - warranty,Payables,97,"226,386.46"
,1/4/2022,Expense,8400023052,Northwood Group,Packing materials,Payables,841.34,"227,227.80"
,8/4/2022,Expense,,Ray St Ledger & Sons,Action,Payables,"1,229.00","228,456.80"
,12/4/2022,Expense,II2414332,Cooksongold,9ct Yellow DF Sheet 1.2 mm gold,Payables,328.68,"228,785.48"
,15/04/2022,Ledger Entry,3077,,Hornadey/Ancient .450 Ancient Fund Transfer to COS,-Split-,367.14,"229,152.62"
,20/04/2022,Expense,1711,TimberLake Workshop,Custom floor plate,Payables,12,"229,164.62"
,20/04/2022,Expense,8400026012,Northwood Group,Freight charge for our shipment with Schenker,Payables,331.63,"229,496.25"
,20/04/2022,Expense,,SRS Freight Ltd,Packing,Payables,60,"229,556.25"
,21/04/2022,Expense,1702,Helston Gunsmiths,Extractor single leg left & right EN9,Payables,28,"229,584.25"
,27/04/2022,Expense,600521,Traditional English Guncases Ltd,Fleece lined canvas and leather slip for pattern supplied - for Mr Hudson,Payables,395,"229,979.25"
,27/04/2022,Expense,1723,TimberLake Workshop,Laser engraving EU spec mark,Payables,8,"229,987.25"
,27/04/2022,Expense,67,Ray St Ledger & Sons,Delivery,Payables,15,"230,002.25"
,27/04/2022,Expense,2.10E+13,Northwood Group UK Vendor,Northwood R8 Semi Weight cal. 308 barrel,Payables,"1,359.00","231,361.25"
,29/04/2022,Ledger Entry,3081,,S2M1FT2028,-Split-,18.2,"231,379.45"
,29/04/2022,Ledger Entry,3081,,S2M1FT0300,-Split-,4,"231,383.45"
,29/04/2022,Ledger Entry,3081,,S2M1FT1945,-Split-,6,"231,389.45"
,29/04/2022,Ledger Entry,3081,,S2M1FT0292,-Split-,26.44,"231,415.89"
,29/04/2022,Ledger Entry,3081,,S2M1FT0277,-Split-,2,"231,417.89"
,29/04/2022,Ledger Entry,3081,,S2M1FT0276,-Split-,2,"231,419.89"
,29/04/2022,Ledger Entry,3081,,S2M1FT1421,-Split-,3.8,"231,423.69"
,29/04/2022,Ledger Entry,3081,,S2M1FT2010,-Split-,0,"231,423.69"
,29/04/2022,Ledger Entry,3081,,S2M1FT2009,-Split-,0,"231,423.69"
,29/04/2022,Ledger Entry,3081,,S2M1FT2006,-Split-,11.39,"231,435.08"
,29/04/2022,Ledger Entry,3081,,S2M1FT1123,-Split-,638,"232,073.08"
,29/04/2022,Ledger Entry,3081,,S2M1FT1800,-Split-,30.96,"232,104.04"
,29/04/2022,Ledger Entry,3081,,S2M1FT1778 x 2,-Split-,644.54,"232,748.58"
,29/04/2022,Ledger Entry,3081,,S2M1FT2016,-Split-,14.5,"232,763.08"
,29/04/2022,Ledger Entry,3081,,S2M1FT2026,-Split-,21,"232,784.08"
,29/04/2022,Ledger Entry,3081,,S2M1FT1723,-Split-,109.38,"232,893.46"
,29/04/2022,Ledger Entry,3081,,S2M1FT0370,-Split-,51.74,"232,945.20"
,29/04/2022,Ledger Entry,3081,,S2M1FT0363,-Split-,78,"233,023.20"
,29/04/2022,Ledger Entry,3081,,S2M1FT1728,-Split-,5.67,"233,028.87"
,29/04/2022,Ledger Entry,3081,,S2M1FT0378,-Split-,0.03,"233,028.90"
,29/04/2022,Ledger Entry,3081,,S2M1FT0211,-Split-,32.93,"233,061.83"
,29/04/2022,Ledger Entry,3081,,S2M1FT0301,-Split-,16.97,"233,078.80"
,29/04/2022,Ledger Entry,3081,,S2M1FT0235,-Split-,12.41,"233,091.21"
,29/04/2022,Ledger Entry,3081,,S2M1FT1819,-Split-,12.8,"233,104.01"
,29/04/2022,Ledger Entry,3081,,S2M1FT2010,-Split-,0,"233,104.01"
,29/04/2022,Ledger Entry,3081,,S2M1FT2009,-Split-,0,"233,104.01"
,29/04/2022,Ledger Entry,3081,,S2M1FT0217,-Split-,34.79,"233,138.80"
,29/04/2022,Expense,,T & D O'Neill,Transport,Payables,100,"233,238.80"
,30/04/2022,Expense,3091085068,Leica Camera AG,Magnus 2.4-16x56 i,Payables,"1,591.70","234,830.50"
,30/04/2022,Ledger Entry,3111,,Harper office Packing Material  April  2021,-Split-,225.62,"235,056.12"
,30/04/2022,Ledger Entry,3112,,accessories sale in April  to cost of sale,-Split-,"7,525.49","242,581.61"
,30/04/2022,Ledger Entry,3112,,Accrual for s/n 19375,-Split-,"4,000.00","246,581.61"
,30/04/2022,Ledger Entry,3112,,being release3d from WIP,-Split-,"74,670.02","321,251.63"
,30/04/2022,Bank Draft,889,,storage box,Business Card,41.65,"321,293.28"
,1/5/2022,Expense,44188,The Company of Gunmakers,9.3x62mm BOLT INSTANT REPROOF,Payables,53.25,"321,346.53"
,1/5/2022,Expense,44188,The Company of Gunmakers,.270 WIN MODERATOR INSTANT PROOF,Payables,38.63,"321,385.16"
,1/5/2022,Expense,75386,Kerast,Vacuum annealed - 14456,Payables,2.96,"321,388.12"
,1/5/2022,Expense,75386,Kerast,Vacuum annealed - 14474,Payables,2.96,"321,391.08"
,1/5/2022,Expense,75386,Kerast,Vacuum annealed - 14515,Payables,2.96,"321,394.04"
,1/5/2022,Expense,75386,Kerast,Vacuum annealed - 14517,Payables,2.96,"321,397.00"
,1/5/2022,Expense,75386,Kerast,Vacuum annealed -14528,Payables,2.96,"321,399.96"
,1/5/2022,Expense,75386,Kerast,Vacuum annealed- 14531,Payables,2.96,"321,402.92"
,1/5/2022,Expense,75386,Kerast,Vacuum annealed - 14533,Payables,2.96,"321,405.88"
,1/5/2022,Expense,75386,Kerast,Vacuum annealed - 14540,Payables,2.96,"321,408.84"
,1/5/2022,Expense,75386,Kerast,Vacuum annealed - 14549,Payables,2.96,"321,411.80"
,1/5/2022,Expense,75386,Kerast,Vacuum annealed - 14586,Payables,2.96,"321,414.76"
,1/5/2022,Expense,75386,Kerast,Vacuum annealed - 14588,Payables,2.96,"321,417.72"
,1/5/2022,Expense,75386,Kerast,Vacuum annealed - 14634,Payables,2.96,"321,420.68"
,1/5/2022,Expense,75386,Kerast,Vacuum annealed - 14635,Payables,2.96,"321,423.64"
,1/5/2022,Expense,75386,Kerast,Vacuum annealed - 14640,Payables,2.96,"321,426.60"
,1/5/2022,Expense,75386,Kerast,Vacuum annealed - 14646,Payables,2.97,"321,429.57"
,1/5/2022,Expense,75386,Kerast,Vacuum annealed - 14661,Payables,2.97,"321,432.54"
,1/5/2022,Expense,75386,Kerast,Vacuum annealed - 14663,Payables,2.97,"321,435.51"
,1/5/2022,Expense,75386,Kerast,Vacuum annealed - 14682,Payables,2.97,"321,438.48"
,1/5/2022,Expense,75386,Kerast,Vacuum annealed - 14693,Payables,2.97,"321,441.45"
,1/5/2022,Expense,75386,Kerast,Vacuum annealed - 14717,Payables,2.97,"321,444.42"
,1/5/2022,Expense,75386,Kerast,Vacuum annealed - 14719,Payables,2.97,"321,447.39"
,1/5/2022,Expense,75386,Kerast,Vacuum annealed - 14721,Payables,2.97,"321,450.36"
,1/5/2022,Expense,75386,Kerast,Vacuum annealed - 14731,Payables,2.97,"321,453.33"
,1/5/2022,Expense,75386,Kerast,Vacuum annealed - 14732,Payables,2.97,"321,456.30"
,1/5/2022,Expense,75386,Kerast,Vacuum annealed - 14735,Payables,2.97,"321,459.27"
,1/5/2022,Expense,14792,Northwood Group UK Vendor,"Sauer 404 270 Wibn
To be Receiptd to Sheikh Khalid",Payables,399,"321,858.27"
,1/5/2022,Expense,,Kerast,Hardness Testing,Payables,145.5,"322,003.77"
,1/5/2022,Expense,75386,Kerast,Vacuum annealed - 14759,Payables,2.97,"322,006.74"
,1/5/2022,Expense,75386,Kerast,Vacuum annealed - 14751,Payables,2.97,"322,009.71"
,1/5/2022,Expense,75386,Kerast,Vacuum annealed - 14739,Payables,2.97,"322,012.68"
,5/5/2022,Expense,2857,DMC Custom Cartridges,620-900 Woodleigh #01 RN SN Projectiles,Payables,450,"322,462.68"
,5/5/2022,Expense,2857,DMC Custom Cartridges,620-900 Woodleigh #02 FMJ Projectiles,Payables,300,"322,762.68"
,9/5/2022,Expense,2861,DMC Custom Cartridges,"350 Ancient Magnum ammunition ref 181004
(120)",Payables,300,"323,062.68"
,10/5/2022,Expense,Sales Order,Wbc,Sticker,Payables,300,"323,362.68"
,11/5/2022,Ledger Entry,3113,,Edmund bell refund,-Split-,-44.74,"323,317.94"
,12/5/2022,Expense,44358,The Company of Gunmakers,"VIEW FEE: .303 BRIT B/A RIFLE
SERIAL NO: 3039
FAILED PRE-PROOF: CHS/CHS NO GO",Payables,13.25,"323,331.19"
,14/05/2022,Expense,INV102749,SRS Freight Ltd,Freight,Payables,120,"323,451.19"
,14/05/2022,Expense,INV102749,SRS Freight Ltd,Export Documentation & Customs,Payables,70,"323,521.19"
,14/05/2022,Expense,INV102749,SRS Freight Ltd,Airline Handling (Export),Payables,275,"323,796.19"
,14/05/2022,Expense,INV102749,SRS Freight Ltd,Cartage,Payables,70,"323,866.19"
,14/05/2022,Expense,INV102749,SRS Freight Ltd,Cargo Collect/Deliver,Payables,43.7,"323,909.89"
,14/05/2022,Expense,INV102749,SRS Freight Ltd,Ancillary Charges,Payables,16.5,"323,926.39"
,14/05/2022,Expense,INV102749,SRS Freight Ltd,Packing,Payables,50,"323,976.39"
,14/05/2022,Expense,INV102748,SRS Freight Ltd,Packing,Payables,50,"324,026.39"
,14/05/2022,Expense,INV102748,SRS Freight Ltd,Ancillary Charges,Payables,16.5,"324,042.89"
,14/05/2022,Expense,INV102748,SRS Freight Ltd,Cargo Collect/Deliver,Payables,43.12,"324,086.01"
,14/05/2022,Expense,INV102748,SRS Freight Ltd,Cartage,Payables,70,"324,156.01"
,14/05/2022,Expense,INV102748,SRS Freight Ltd,Airline Handling (Export),Payables,273,"324,429.01"
,14/05/2022,Expense,INV102748,SRS Freight Ltd,Freight,Payables,120,"324,549.01"
,14/05/2022,Expense,INV102748,SRS Freight Ltd,Export Documentation & Customs,Payables,70,"324,619.01"
,17/05/2022,Expense,1351,Broadbent Leather goods,Delivery,Payables,10,"324,629.01"
,17/05/2022,Expense,1351,Broadbent Leather goods,"Artwork and sundry revisions, and printing of two sheets",Payables,85,"324,714.01"
,17/05/2022,Expense,1351,Broadbent Leather goods,"Removing Case, tipping in extra page and re-casing blue cloth book",Payables,12,"324,726.01"
,17/05/2022,Expense,1351,Broadbent Leather goods,Tipping in extra page,Payables,3,"324,729.01"
,17/05/2022,Expense,1351,Broadbent Leather goods,Shooting book in black croc-print leather,Payables,58.75,"324,787.76"
,17/05/2022,Expense,44364,The Company of Gunmakers,Sako.243 Win B/A Rifle proof serial No Y83609,Payables,23.5,"324,811.26"
,31/05/2022,Ledger Entry,3179,,"LTC Released Gordy and Son (Modessett)
s/n 18727",-Split-,"27,760.56","352,571.82"
,31/05/2022,Ledger Entry,3124,,S2M1FT2018,-Split-,14.57,"352,586.39"
,31/05/2022,Ledger Entry,3124,,S2M1FT0217,-Split-,34.79,"352,621.18"
,31/05/2022,Ledger Entry,3124,,S2M1FT2006,-Split-,11.39,"352,632.57"
,31/05/2022,Ledger Entry,3124,,S2M1FT0205,-Split-,60.07,"352,692.64"
,31/05/2022,Ledger Entry,3124,,S2M1FT2022,-Split-,18.9,"352,711.54"
,31/05/2022,Ledger Entry,3124,,S2M1FT2028,-Split-,18.2,"352,729.74"
,31/05/2022,Ledger Entry,3124,,S2M1FT2004,-Split-,29.9,"352,759.64"
,31/05/2022,Ledger Entry,3124,,S2M1FT0213,-Split-,31.42,"352,791.06"
,31/05/2022,Ledger Entry,3124,,S2M1FT0194,-Split-,29.88,"352,820.94"
,31/05/2022,Ledger Entry,3124,,S2M1FT2026,-Split-,21,"352,841.94"
,31/05/2022,Ledger Entry,3124,,S2M1FT0199,-Split-,29,"352,870.94"
,31/05/2022,Ledger Entry,3124,,S2M1FT2021,-Split-,17.25,"352,888.19"
,31/05/2022,Ledger Entry,3124,,S2M1FT2023,-Split-,15.36,"352,903.55"
,31/05/2022,Ledger Entry,3124,,S2M1FT2007,-Split-,16.22,"352,919.77"
,31/05/2022,Ledger Entry,3124,,S2M1FT0187,-Split-,27.5,"352,947.27"
,31/05/2022,Ledger Entry,3124,,S2M1FT2028,-Split-,16.38,"352,963.65"
,31/05/2022,Ledger Entry,3124,,S2M1FT2018,-Split-,14.57,"352,978.22"
,31/05/2022,Ledger Entry,3124,,S2M1FT1979,-Split-,4.95,"352,983.17"
,31/05/2022,Ledger Entry,3124,,S2M1FT1978,-Split-,8.55,"352,991.72"
,31/05/2022,Ledger Entry,3124,,S2M1FT0374,-Split-,0,"352,991.72"
,31/05/2022,Ledger Entry,3124,,S2M1FT1397,-Split-,0,"352,991.72"
,31/05/2022,Ledger Entry,3124,,S2M1FT2021,-Split-,17.25,"353,008.97"
,31/05/2022,Ledger Entry,3124,,S2M1FT2023,-Split-,15.36,"353,024.33"
,31/05/2022,Bank Draft,972,,cookson gold,Business Card,70.28,"353,094.61"
,31/05/2022,Bank Draft,962,,cookson gold,Business Card,142.03,"353,236.64"
,31/05/2022,Expense,600550,Traditional English Guncases Ltd,Oak & Leather Case for .350 Ancient: Take Down rifle London,Payables,"7,000.00","360,236.64"
,31/05/2022,Ledger Entry,3141,,Sidney Hiscox accessories,-Split-,"1,937.70","362,174.34"
,31/05/2022,Ledger Entry,3141,,being released to P&L accessories stock,-Split-,"15,201.38","377,375.72"
,31/05/2022,Ledger Entry,3141,,being released to P&L s/n 10800,-Split-,"31,836.14","409,211.86"
,31/05/2022,Ledger Entry,3115,,Harper office Packing Material  May  2021,-Split-,225.62,"409,437.48"
,31/05/2022,Ledger Entry,3179,,"LTC Released Gordy and Son (Modessett)
s/n 18728",-Split-,"24,884.94","434,322.42"
,1/6/2022,Expense,,The Company of Gunmakers,Ancient .500 NE DOUBLE RIFLE INSTANT PROOF,Payables,329.76,"434,652.18"
,1/6/2022,Expense,1191JRL,Laser Welding Services,1off Safety Catch Slide,Payables,120,"434,772.18"
,1/6/2022,Expense,1191JRL,Laser Welding Services,Postage,Payables,11.85,"434,784.03"
,1/6/2022,Expense,156,Fox & Co Bespokw Ltd,"En-14398grave Arab crest, as per photo from Jamie",Payables,140,"434,924.03"
,1/6/2022,Expense,1332,Broadbent Leather goods,Shooting book in brown croc-print leather,Payables,390,"435,314.03"
,1/6/2022,Expense,1351,Broadbent Leather goods,Shooting book in brown croc-print leather,Payables,58.75,"435,372.78"
,1/6/2022,Expense,1351,Broadbent Leather goods,"Removing case, tipping in extra page and re-casing blue cloth book",Payables,12,"435,384.78"
,1/6/2022,Expense,1351,Broadbent Leather goods,"Artwork and sundry revisions, and printing of two frontis sheets (one
in colour",Payables,85,"435,469.78"
,1/6/2022,Expense,1351,Broadbent Leather goods,Tipping in extra page,Payables,3,"435,472.78"
,1/6/2022,Expense,44372,The Company of Gunmakers,CARRIAGE- NEXT WORKING DAY,Payables,50,"435,522.78"
,1/6/2022,Expense,44389,The Company of Gunmakers,NNJ CUSTOM .243 WIN B/A RIFLE REPROOF,Payables,110.25,"435,633.03"
,3/6/2022,Expense,1771,TimberLake Workshop,Brass plate with engraving for 19375,Payables,50,"435,683.03"
,7/6/2022,Expense,PRO FORMA 201-905-636,Classic Shooting Switzerland,"Daniel Fraser & Co Ltd, Edinburgh,
Barrel Takedown Bolt Magazine Sporting Rifle,
Serial No.: 3314
Caliber: .303",Payables,"12,214.48","447,897.51"
,11/6/2022,Expense,32,Steve Kelly,Swiss edition Mag Box plate,Payables,325,"448,222.51"
,14/06/2022,Expense,600562,Traditional English Guncases Ltd,"Full length Green Canvas Rifle. With Case for 
a Corbett
pattern Rifle.No 7018",Payables,"1,200.00","449,422.51"
,14/06/2022,Expense,600560,Traditional English Guncases Ltd,"Full length Oak Rimmed Case for London Best
B/A Rifle with scope on.-Gun No 7080
Canvas outer cover to match",Payables,"2,750.00","452,172.51"
,14/06/2022,Expense,44436,The Company of Gunmakers,"1.00 .350 Ancient MAGNUM B/A RIFLE INSTANT PROOF
SERIAL NO: 7070",Payables,49.5,"452,222.01"
,14/06/2022,Expense,600559,Traditional English Guncases Ltd,"Lightweight Rifle Case to house H&H Rifle and Scope.
With one canvans cover",Payables,"1,800.00","454,022.01"
,14/06/2022,Expense,44435,The Company of Gunmakers,"Northwood K95 6.5 CREEDMOOR S/S RIFLE REPROOF
SERIAL NO: 3/112300",Payables,40,"454,062.01"
,15/06/2022,Vendor Credit,CN-14940,Northwood Group UK Vendor,"Debit Memo against Receipt no 13060,13424",Payables,-492,"453,570.01"
,18/06/2022,Expense,102835,SRS Freight Ltd,Freight,Payables,"3,636.00","457,206.01"
,18/06/2022,Expense,102835,SRS Freight Ltd,Export Documentation & Customs,Payables,70,"457,276.01"
,18/06/2022,Expense,102835,SRS Freight Ltd,Airline Handling (Export),Payables,"1,068.70","458,344.71"
,18/06/2022,Expense,102835,SRS Freight Ltd,Cartage,Payables,110,"458,454.71"
,18/06/2022,Expense,102835,SRS Freight Ltd,Ancillary Charges,Payables,16.5,"458,471.21"
,18/06/2022,Expense,102835,SRS Freight Ltd,SRS Storage,Payables,455,"458,926.21"
,18/06/2022,Expense,102835,SRS Freight Ltd,Cargo Collect/Deliver,Payables,210.74,"459,136.95"
,23/06/2022,Expense,INV102834,SRS Freight Ltd,Import  Documentation & Customs,Payables,85,"459,221.95"
,23/06/2022,Expense,INV102834,SRS Freight Ltd,Airline Handling (Export),Payables,240,"459,461.95"
,23/06/2022,Expense,INV102834,SRS Freight Ltd,Cartage,Payables,78.5,"459,540.45"
,23/06/2022,Expense,INV102834,SRS Freight Ltd,Cargo Collect/Deliver,Payables,43.99,"459,584.44"
,23/06/2022,Expense,INV102834,SRS Freight Ltd,Ancillary Charges,Payables,16.5,"459,600.94"
,23/06/2022,Expense,INV102836,SRS Freight Ltd,Export Documentation & Customs,Payables,70,"459,670.94"
,23/06/2022,Expense,INV102836,SRS Freight Ltd,Freight,Payables,"1,808.00","461,478.94"
,23/06/2022,Expense,INV102836,SRS Freight Ltd,Cartage,Payables,110,"461,588.94"
,23/06/2022,Expense,INV102836,SRS Freight Ltd,Airline Handling (Export),Payables,517.7,"462,106.64"
,23/06/2022,Expense,INV102836,SRS Freight Ltd,Cargo Collect/Deliver,Payables,100.54,"462,207.18"
,23/06/2022,Expense,INV102836,SRS Freight Ltd,Ancillary Charges,Payables,16.5,"462,223.68"
,23/06/2022,Expense,INV102836,SRS Freight Ltd,Packing,Payables,160,"462,383.68"
,29/06/2022,Expense,12,T & D O'Neill,Transport,Payables,780,"463,163.68"
,30/06/2022,Ledger Entry,3175,,being released to COS accessories,-Split-,"6,061.12","469,224.80"
,30/06/2022,Ledger Entry,3160,,S2M1FT1800,-Split-,30.96,"469,255.76"
,30/06/2022,Ledger Entry,3160,,S2M1FT1689,-Split-,139.3,"469,395.06"
,30/06/2022,Ledger Entry,3160,,S2M1FT0300,-Split-,2,"469,397.06"
,30/06/2022,Ledger Entry,3160,,S2M1FT2058,-Split-,3.9,"469,400.96"
,30/06/2022,Ledger Entry,3160,,S2M1FT2005,-Split-,11.72,"469,412.68"
,30/06/2022,Ledger Entry,3160,,S2M1FT0190,-Split-,16.73,"469,429.41"
,30/06/2022,Ledger Entry,3160,,S2M1FT0397,-Split-,79,"469,508.41"
,30/06/2022,Ledger Entry,3160,,S2M1FT0292,-Split-,26.64,"469,535.05"
,30/06/2022,Ledger Entry,3160,,S2M1FT2028,-Split-,18.2,"469,553.25"
,30/06/2022,Ledger Entry,3160,,S2M1FT0193,-Split-,22.35,"469,575.60"
,30/06/2022,Ledger Entry,3160,,S2M1FT0328,-Split-,6.84,"469,582.44"
,30/06/2022,Ledger Entry,3160,,S2M1FT2066,-Split-,54,"469,636.44"
,30/06/2022,Ledger Entry,3175,,being released to P & L,-Split-,"136,812.47","606,448.91"
,30/06/2022,Ledger Entry,3175,,Accrual for Andy Miles Receipt for 14714,-Split-,267.65,"606,716.56"
,30/06/2022,Ledger Entry,3173,,Harper office Packing Material  June 2021,-Split-,225.62,"606,942.18"
,30/06/2022,Ledger Entry,3160,,S2M1FT0941,-Split-,2,"606,944.18"
,30/06/2022,Expense,75699,Kerast,Hardness Test,Payables,48.5,"606,992.68"
,30/06/2022,Expense,75699,Kerast,Vacuum Annealed,Payables,175,"607,167.68"
,30/06/2022,Bank Draft,1042,,wine box,Business Card,128.7,"607,296.38"
,30/06/2022,Bank Draft,1045,,wine box,Business Card,16.98,"607,313.36"
,30/06/2022,Expense,318,Johnsons & Co Ltd,Best Black,Payables,390,"607,703.36"
,30/06/2022,Ledger Entry,3160,,S2M1FT0184,-Split-,38.51,"607,741.87"
,1/7/2022,Expense,INV102843,SRS Freight Ltd,Airline Handling (Min,Payables,240,"607,981.87"
,1/7/2022,Expense,INV102843,SRS Freight Ltd,Import Documentation & Customs,Payables,85,"608,066.87"
,1/7/2022,Expense,INV102843,SRS Freight Ltd,Use of Standing Cash Deposit,Payables,80.81,"608,147.68"
,1/7/2022,Expense,INV102843,SRS Freight Ltd,Ancillary Charges,Payables,16.5,"608,164.18"
,1/7/2022,Expense,INV102843,SRS Freight Ltd,Cargo Collect/Deliver,Payables,40,"608,204.18"
,1/7/2022,Expense,INV102843,SRS Freight Ltd,Cartage,Payables,70,"608,274.18"
,1/7/2022,Expense,,SRS Freight Ltd,ImpImport Duty/Import Tax,Payables,238.72,"608,512.90"
,1/7/2022,Ledger Entry,3186,,being released to cost of sale adj,-Split-,"1,014.24","609,527.14"
,2/7/2022,Expense,705046,Jay Spark Co Ltd,Tools,Payables,35.72,"609,562.86"
,5/7/2022,Expense,102863,SRS Freight Ltd,Export Documentation & Customs,Payables,85,"609,647.86"
,5/7/2022,Expense,102863,SRS Freight Ltd,Airline Handling (Export),Payables,270,"609,917.86"
,5/7/2022,Expense,102863,SRS Freight Ltd,Ancillary Charges,Payables,16.5,"609,934.36"
,5/7/2022,Expense,102863,SRS Freight Ltd,Cartage,Payables,70,"610,004.36"
,5/7/2022,Expense,102863,SRS Freight Ltd,Cargo Collect/Deliver,Payables,40,"610,044.36"
,7/7/2022,Expense,ORD05198,Durable Fasteners Ltd,TOOLING KB 6H/15 Ancient D73063,Payables,179,"610,223.36"
,12/7/2022,Expense,INV102900,SRS Freight Ltd,Freight,Payables,355.2,"610,578.56"
,12/7/2022,Expense,INV102900,SRS Freight Ltd,Export Documentation & Customs,Payables,70,"610,648.56"
,12/7/2022,Expense,INV102900,SRS Freight Ltd,Airline Handling (Export),Payables,196.5,"610,845.06"
,12/7/2022,Expense,INV102900,SRS Freight Ltd,Cargo Collect/Deliver,Payables,45.73,"610,890.79"
,12/7/2022,Expense,INV102900,SRS Freight Ltd,Ancillary Charges,Payables,16.5,"610,907.29"
,12/7/2022,Expense,INV102900,SRS Freight Ltd,Packing,Payables,100,"611,007.29"
,12/7/2022,Expense,INV102900,SRS Freight Ltd,Cartage,Payables,81.5,"611,088.79"
,15/07/2022,Expense,17630,Kynamco Limited,Cost of Sale to Dan Walker,Payables,19.8,"611,108.59"
,15/07/2022,Expense,17630,Kynamco Limited,Carriage,Payables,3.9,"611,112.49"
,19/07/2022,Expense,INV102914,SRS Freight Ltd,Cartage,Payables,70,"611,182.49"
,19/07/2022,Expense,INV-1821,TimberLake Workshop,Engraved plates custom framing,Payables,180,"611,362.49"
,19/07/2022,Expense,INV-1821,TimberLake Workshop,Elephant framing,Payables,251,"611,613.49"
,19/07/2022,Expense,INV-1821,TimberLake Workshop,Rhino framing,Payables,153.6,"611,767.09"
,19/07/2022,Expense,INV-1821,TimberLake Workshop,Lions Eyes framing,Payables,164.4,"611,931.49"
,19/07/2022,Expense,INV-1821,TimberLake Workshop,Wild dog framing,Payables,75.8,"612,007.29"
,19/07/2022,Expense,INV-1821,TimberLake Workshop,Lionness head,Payables,71,"612,078.29"
,19/07/2022,Expense,INV-1821,TimberLake Workshop,Cheetah/lion framing,Payables,112,"612,190.29"
,19/07/2022,Expense,INV102914,SRS Freight Ltd,Freight,Payables,180,"612,370.29"
,19/07/2022,Expense,INV102914,SRS Freight Ltd,Export Documentation & Customs,Payables,70,"612,440.29"
,19/07/2022,Expense,INV102914,SRS Freight Ltd,Airline Handling (Export),Payables,298,"612,738.29"
,19/07/2022,Expense,INV102914,SRS Freight Ltd,Cargo Collect/Deliver,Payables,50.37,"612,788.66"
,19/07/2022,Expense,INV102914,SRS Freight Ltd,Ancillary Charges,Payables,16.5,"612,805.16"
,19/07/2022,Expense,INV102914,SRS Freight Ltd,Packing,Payables,95,"612,900.16"
,20/07/2022,Expense,INV102918,SRS Freight Ltd,Cargo Collect/Deliver,Payables,48.63,"612,948.79"
,20/07/2022,Expense,INV102918,SRS Freight Ltd,Export Documentation & Customs,Payables,70,"613,018.79"
,20/07/2022,Expense,INV102918,SRS Freight Ltd,Cartage,Payables,86.5,"613,105.29"
,20/07/2022,Expense,INV102918,SRS Freight Ltd,Freight,Payables,350,"613,455.29"
,20/07/2022,Expense,INV102917,SRS Freight Ltd,Packing,Payables,"1,200.00","614,655.29"
,20/07/2022,Expense,INV102918,SRS Freight Ltd,Airline Handling (Export),Payables,292,"614,947.29"
,20/07/2022,Expense,INV102917,SRS Freight Ltd,Ancillary Charges,Payables,16.5,"614,963.79"
,20/07/2022,Expense,INV102917,SRS Freight Ltd,Cargo Collect/Deliver,Payables,155,"615,118.79"
,20/07/2022,Expense,INV102917,SRS Freight Ltd,Cartage,Payables,215,"615,333.79"
,20/07/2022,Expense,INV102918,SRS Freight Ltd,Ancillary Charges,Payables,16.5,"615,350.29"
,20/07/2022,Expense,INV102918,SRS Freight Ltd,Packing,Payables,75,"615,425.29"
,20/07/2022,Expense,INV102917,SRS Freight Ltd,Freight,Payables,"2,832.40","618,257.69"
,20/07/2022,Expense,INV102917,SRS Freight Ltd,Export Documentation & Customs,Payables,70,"618,327.69"
,20/07/2022,Expense,INV102917,SRS Freight Ltd,Airline Handling (Export),Payables,943.25,"619,270.94"
,22/07/2022,Expense,INV102931,SRS Freight Ltd,Export Documentation & Customs,Payables,70,"619,340.94"
,22/07/2022,Expense,INV102931,SRS Freight Ltd,Freight,Payables,545,"619,885.94"
,22/07/2022,Expense,INV102931,SRS Freight Ltd,Airline Handling (Export),Payables,320.35,"620,206.29"
,22/07/2022,Expense,INV102931,SRS Freight Ltd,Cartage,Payables,70,"620,276.29"
,22/07/2022,Expense,INV102931,SRS Freight Ltd,Cargo Collect/Deliver,Payables,66.61,"620,342.90"
,22/07/2022,Expense,INV102931,SRS Freight Ltd,Ancillary Charges,Payables,16.5,"620,359.40"
,22/07/2022,Expense,INV102931,SRS Freight Ltd,Packing,Payables,95,"620,454.40"
,31/07/2022,Ledger Entry,3216,,being released to P&L,-Split-,"10,121.21","630,575.61"
,31/07/2022,Ledger Entry,3216,,being released to P&L,-Split-,"126,389.03","756,964.64"
,31/07/2022,Ledger Entry,3214,,Cookson Gold  refund,-Split-,-63.36,"756,901.28"
,31/07/2022,Ledger Entry,3217,,Accrual for S/N 14802,-Split-,400,"757,301.28"
,31/07/2022,Ledger Entry,3217,,Accrual for S/N 7065,-Split-,"2,500.00","759,801.28"
,31/07/2022,Ledger Entry,3217,,Accrual for S/N 18707,-Split-,"5,000.00","764,801.28"
,31/07/2022,Ledger Entry,3213,,S2M1FT0393,-Split-,68,"764,869.28"
,31/07/2022,Ledger Entry,3213,,S2M1FT0315,-Split-,1.5,"764,870.78"
,31/07/2022,Ledger Entry,3213,,S2M1FT2008,-Split-,14.96,"764,885.74"
,31/07/2022,Ledger Entry,3213,,S2M1FT0319,-Split-,2.28,"764,888.02"
,31/07/2022,Ledger Entry,3213,,S2M1FT0287,-Split-,11.62,"764,899.64"
,31/07/2022,Ledger Entry,3213,,S2M1FT0274,-Split-,2,"764,901.64"
,31/07/2022,Ledger Entry,3213,,S2M1FT0221,-Split-,4.98,"764,906.62"
,31/07/2022,Ledger Entry,3213,,S2M1FT0274,-Split-,2,"764,908.62"
,31/07/2022,Ledger Entry,3213,,S2M1FT0221,-Split-,2.49,"764,911.11"
,31/07/2022,Ledger Entry,3215,,Harper office Packing Material  July 2021,-Split-,225.62,"765,136.73"
,31/07/2022,Expense,,T & D O'Neill,Wood collection,Payables,"1,760.00","766,896.73"
,31/07/2022,Expense,,T & D O'Neill,Wood collection,Payables,100,"766,996.73"
,31/07/2022,Bank Draft,1067,,Ancient art cost framing,Business Card,174.06,"767,170.79"
,31/07/2022,Ledger Entry,3198,,Loick July WIP Salary allocation,-Split-,5.82,"767,176.61"
,31/07/2022,Ledger Entry,3215,,WBC  bags,-Split-,376.67,"767,553.28"
,1/8/2022,Expense,600590,Traditional English Guncases Ltd,"Repair - To small MDF Box for Bore Gauge.
Leather Cover Box
Fit lock and handle and chapes.
Fit Inside for gauges supplied",Payables,800,"768,353.28"
,1/8/2022,Expense,600589,Traditional English Guncases Ltd,"Repair of Full length Canvas Case. Altered
Interior for large scope",Payables,120,"768,473.28"
,1/8/2022,Expense,2.11E+13,Northwood Group,COS - To Carl King Receipt ref: 12488,Payables,229,"768,702.28"
,24/08/2022,Ledger Entry,3226,,S2M1FT0220,-Split-,42.74,"768,745.02"
,24/08/2022,Ledger Entry,3226,,S2M1FT2028,-Split-,18.2,"768,763.22"
,30/08/2022,Expense,600622,Traditional English Guncases Ltd,Fitted N/Tab to cover 'Stamped TK' - for 18707,Payables,25,"768,788.22"
,31/08/2022,Bank Draft,1237,,3dgbire.com,Business Card,40.1,"768,828.32"
,31/08/2022,Bank Draft,1238,,"Archive Cardboard Boxes with Handles, 64 litres",Business Card,15.49,"768,843.81"
,31/08/2022,Bank Draft,1240,,"Archive Cardboard Boxes with Handles, 64 litres",Business Card,15.49,"768,859.30"
,31/08/2022,Ledger Entry,3247,,Accrual for s/n 14654,-Split-,"8,000.00","776,859.30"
,31/08/2022,Ledger Entry,3247,,Accrual for Swarovski Receipt John Reed,-Split-,"1,592.00","778,451.30"
,31/08/2022,Ledger Entry,3246,,being released to P & L,-Split-,"8,614.02","787,065.32"
,31/08/2022,Ledger Entry,3246,,being released to P & L,-Split-,"156,981.05","944,046.37"
,31/08/2022,Ledger Entry,3250,,Russell Gordy defender 110 16/12/2020 being Fund Transferred to P&L,-Split-,"41,666.66","985,713.03"
,31/08/2022,Ledger Entry,3247,,Accrual for Russell Gordy defender s/n RG1,-Split-,"38,334.00","1,024,047.03"
,31/08/2022,Ledger Entry,3249,,WBC  bags,-Split-,376.67,"1,024,423.70"
,31/08/2022,Ledger Entry,3249,,Harper office Packing August July 2021,-Split-,225.62,"1,024,649.32"
,31/08/2022,Ledger Entry,3247,,Accrual for blacking s/n 18726,-Split-,"2,500.00","1,027,149.32"
,31/08/2022,Bank Draft,1181,Cooksongold,Gold for Engraving,Business Card,79.92,"1,027,229.24"
,31/08/2022,Bank Draft,1239,,"Archive Cardboard Boxes with Handles, 64 litres",Business Card,15.49,"1,027,244.73"
,31/08/2022,Bank Draft,1216,Cooksongold,Stock silver ovals,Business Card,253.2,"1,027,497.93"
,1/9/2022,Expense,424,Johnsons & Co Ltd,Repair rifle 1205,Payables,300,"1,027,797.93"
,2/9/2022,Expense,44613,The Company of Gunmakers,Engraving,Payables,10,"1,027,807.93"
,3/9/2022,Expense,14,Ray St Ledger & Sons,Turnscrew - SN 14760,Payables,108,"1,027,915.93"
,13/09/2022,Expense,,Peter Heath Glenser,"A .303 boxlock non-ejector rifle by W.J. Jeffery & Co., 4595 In a John Dickson & Sons brass-mounted oak and leather case",Payables,"8,000.00","1,035,915.93"
,13/09/2022,Expense,2.11E+13,Northwood Group UK Vendor,Northwood F3 30 Luxus pair 20 bore,Payables,"16,050.00","1,051,965.93"
,14/09/2022,Expense,21232504,Swarovski Optik,Repairs telescopic sights,Payables,163.5,"1,052,129.43"
,15/09/2022,Expense,OP/I1778613,GMK,Repair gun,Payables,11.06,"1,052,140.49"
,20/09/2022,Expense,OP/I778868,GMK,Repair gun,Payables,8.8,"1,052,149.29"
,21/09/2022,Expense,10019,Durable Fasteners Ltd,TOOLING KB 6H/15 Ancient D73063,Payables,179,"1,052,328.29"
,23/09/2022,Expense,10124,Durable Fasteners Ltd,Gun cases,Payables,241.62,"1,052,569.91"
,23/09/2022,Expense,1921,TimberLake Workshop,Data set up basic fee,Payables,60,"1,052,629.91"
,30/09/2022,Bank Draft,1320,,ammunition,Business Card,102.43,"1,052,732.34"
,30/09/2022,Ledger Entry,3273,,S2M1FT1963,-Split-,217.24,"1,052,949.58"
,30/09/2022,Ledger Entry,3273,,S2M1FT1963,-Split-,217.24,"1,053,166.82"
,30/09/2022,Ledger Entry,3273,,S2M1FT1963,-Split-,217.24,"1,053,384.06"
,30/09/2022,Ledger Entry,3273,,S2M1FT1963,-Split-,217.24,"1,053,601.30"
,30/09/2022,Ledger Entry,3273,,S2M1FT0445,-Split-,13,"1,053,614.30"
,30/09/2022,Ledger Entry,3273,,S2M1FT0396 - X3,-Split-,237,"1,053,851.30"
,30/09/2022,Ledger Entry,3273,,S2M1FT0300,-Split-,14,"1,053,865.30"
,30/09/2022,Ledger Entry,3273,,S2M1FT0235,-Split-,12.41,"1,053,877.71"
,30/09/2022,Ledger Entry,3273,,S2M1FT1835,-Split-,3.44,"1,053,881.15"
,30/09/2022,Ledger Entry,3273,,S2M1FT1835,-Split-,3.44,"1,053,884.59"
,30/09/2022,Ledger Entry,3273,,S2M1FT1497,-Split-,149.5,"1,054,034.09"
,30/09/2022,Ledger Entry,3273,,S2M1FT2023,-Split-,15.36,"1,054,049.45"
,30/09/2022,Ledger Entry,3273,,S2M1FT2009,-Split-,0,"1,054,049.45"
,30/09/2022,Ledger Entry,3273,,S2M1FT2010,-Split-,0,"1,054,049.45"
,30/09/2022,Ledger Entry,3273,,S2M1FT0358,-Split-,92.64,"1,054,142.09"
,30/09/2022,Ledger Entry,3273,,S2M1FT1689 - X3,-Split-,417.9,"1,054,559.99"
,30/09/2022,Ledger Entry,3273,,S2M1FT0393,-Split-,68,"1,054,627.99"
,30/09/2022,Ledger Entry,3273,,S2M1FT0393,-Split-,68,"1,054,695.99"
,30/09/2022,Ledger Entry,3273,,S2M1FT2187,-Split-,170,"1,054,865.99"
,30/09/2022,Ledger Entry,3281,,Harper office Packing Sept 2021,-Split-,225.62,"1,055,091.61"
,30/09/2022,Ledger Entry,3281,,WBC  bags,-Split-,376.67,"1,055,468.28"
,30/09/2022,Ledger Entry,3279,,Chip Mahan Cartridge bag stamped with initials and set of double gun sleeves,-Split-,"1,422.00","1,056,890.28"
,30/09/2022,Ledger Entry,3279,,being released to P&L,-Split-,"8,481.63","1,065,371.91"
,30/09/2022,Ledger Entry,3279,,being released to P&L,-Split-,"93,159.76","1,158,531.67"
,30/09/2022,Ledger Entry,3273,,S2M1FT2150,-Split-,74,"1,158,605.67"
,30/09/2022,Ledger Entry,3273,,S2M1FT2022,-Split-,18.9,"1,158,624.57"
,30/09/2022,Ledger Entry,3273,,S2M1FT2007,-Split-,16.22,"1,158,640.79"
,30/09/2022,Ledger Entry,3273,,S2M1FT2021,-Split-,17.25,"1,158,658.04"
,30/09/2022,Ledger Entry,3273,,S2M1FT0217,-Split-,34.79,"1,158,692.83"
,30/09/2022,Ledger Entry,3273,,S2M1FT0193,-Split-,22.35,"1,158,715.18"
,30/09/2022,Ledger Entry,3273,,S2M1FT2006,-Split-,11.39,"1,158,726.57"
,30/09/2022,Ledger Entry,3273,,S2M1FT0252,-Split-,32.55,"1,158,759.12"
,30/09/2022,Ledger Entry,3273,,S2M1FT0331,-Split-,38.41,"1,158,797.53"
,30/09/2022,Ledger Entry,3273,,S2M1FT0331,-Split-,38.41,"1,158,835.94"
,30/09/2022,Ledger Entry,3273,,S2M1FT0331,-Split-,38.41,"1,158,874.35"
,30/09/2022,Ledger Entry,3273,,S2M1FT0184,-Split-,38.51,"1,158,912.86"
,30/09/2022,Ledger Entry,3273,,S2M1FT2068,-Split-,152,"1,159,064.86"
,30/09/2022,Ledger Entry,3273,,S2M1FT2068,-Split-,152,"1,159,216.86"
,30/09/2022,Ledger Entry,3273,,S2M1FT2068,-Split-,152,"1,159,368.86"
,30/09/2022,Ledger Entry,3273,,S2M1FT2068,-Split-,152,"1,159,520.86"
,30/09/2022,Ledger Entry,3273,,S2M1FT2068,-Split-,152,"1,159,672.86"
,30/09/2022,Ledger Entry,3273,,S2M1FT2068,-Split-,152,"1,159,824.86"
,30/09/2022,Ledger Entry,3273,,S2M1FT2068,-Split-,152,"1,159,976.86"
,30/09/2022,Ledger Entry,3273,,S2M1FT2068,-Split-,152,"1,160,128.86"
,30/09/2022,Ledger Entry,3273,,S2M1FT2068,-Split-,152,"1,160,280.86"
,30/09/2022,Ledger Entry,3273,,S2M1FT2068,-Split-,152,"1,160,432.86"
,30/09/2022,Ledger Entry,3273,,S2M1FT1963,-Split-,217.24,"1,160,650.10"
,30/09/2022,Ledger Entry,3273,,S2M1FT1963,-Split-,217.24,"1,160,867.34"
,30/09/2022,Ledger Entry,3273,,S2M1FT1963,-Split-,217.24,"1,161,084.58"
,30/09/2022,Ledger Entry,3273,,S2M1FT1963,-Split-,217.24,"1,161,301.82"
,30/09/2022,Ledger Entry,3273,,S2M1FT1963,-Split-,217.24,"1,161,519.06"
,30/09/2022,Ledger Entry,3273,,S2M1FT1963,-Split-,217.24,"1,161,736.30"
,1/10/2022,Expense,1240JRL,Laser Welding Services,1 barrel to build up underside of lug,Payables,190,"1,161,926.30"
,1/10/2022,Vendor Credit,,Durable Fasteners Ltd,correction -duplicate Expense,Payables,-179,"1,161,747.30"
,1/10/2022,Expense,600642,Traditional English Guncases Ltd,Canvas outer cover fitted to canvas big game case,Payables,370,"1,162,117.30"
,1/10/2022,Expense,1784,TimberLake Workshop,Data set up fee,Payables,30,"1,162,147.30"
,1/10/2022,Expense,1784,TimberLake Workshop,Black out mark,Payables,6,"1,162,153.30"
,1/10/2022,Expense,1784,TimberLake Workshop,Import mark custom,Payables,6,"1,162,159.30"
,1/10/2022,Expense,1784,TimberLake Workshop,laser engraving EU spec mark,Payables,6,"1,162,165.30"
,1/10/2022,Expense,1240JRL,Laser Welding Services,Fore end to build up 2 triungular faces,Payables,70,"1,162,235.30"
,1/10/2022,Expense,2.10E+13,Riflecraft Limited,1 hour workshop labour,Payables,45,"1,162,280.30"
,1/10/2022,Expense,1621,TimberLake Workshop,laser engraving EU spec mark,Payables,36,"1,162,316.30"
,1/10/2022,Expense,600641,Traditional English Guncases Ltd,"150 Size Cartridge Bag to match above 
stamped-BJG",Payables,335,"1,162,651.30"
,1/10/2022,Expense,600641,Traditional English Guncases Ltd,Double Leather Slip in Brown Stamped BJG,Payables,850,"1,163,501.30"
,1/10/2022,Expense,600641,Traditional English Guncases Ltd,"150 Size Cartridge Bag to Match above 
-Stamped KMG 3",Payables,335,"1,163,836.30"
,1/10/2022,Expense,600641,Traditional English Guncases Ltd,Double Leather Slip in Dark Brown- Stamped KMG 8,Payables,850,"1,164,686.30"
,1/10/2022,Expense,1621,TimberLake Workshop,Data set up fee,Payables,30,"1,164,716.30"
,1/10/2022,Expense,1621,TimberLake Workshop,Import mark custom,Payables,27,"1,164,743.30"
,7/10/2022,Expense,2021-A-2286,Negrini,"packaging for finished rifles - 1,304.65 EUR",Payables,"1,147.82","1,165,891.12"
,11/10/2022,Expense,44676,The Company of Gunmakers,.416 Ancient (NO.2) S/S RIFLE PROOF,Payables,44.75,"1,165,935.87"
,12/10/2022,Expense,1952,TimberLake Workshop,Import mark custom,Payables,6,"1,165,941.87"
,14/10/2022,Ledger Entry,3287,,"Ancient - .275 Ancient x 74 rnd @ 1.16
Hornady - .416 Ancient x 78 rnd @ 3.69

Range ammunition used on 28/07/2022",-Split-,373.66,"1,166,315.53"
,14/10/2022,Ledger Entry,3287,,"Hornady - 30-06 x 67 rnd @ 1.25
Hornady - .275 Ancient x 25 rnd @ 1.16
Hornady - .375 H&H x 27 rnd @ 2.69
Hornady - .470 NE x 6 rnd @ 6.68

Range ammunition used on 06/10/2022",-Split-,225.46,"1,166,540.99"
,14/10/2022,Ledger Entry,3287,,"Federal - .300 Win Mag x 10 rnd @ 1.94
Federal - .375 H&H x 48 rnd @ 3.55
Hornady - .375 H&H x 20 rnd @ 2.69
Ancient - .275 Ancient x 3 rnd @ 1.16
Federal - 7x57 x 3 rnd @ 1.26
Hornady - .470 NE x 6 rnd @ 6.68
Hornady - .308 Win x 20 rnd @ 1.25

Range ammunition used on 23/09/2022",-Split-,290.94,"1,166,831.93"
,14/10/2022,Ledger Entry,3287,,"PPU - 7.5x55 x 15 rnd @ 2.17
Norma - 7.5x55 x 95 rnd @ 2.03
Ancient - .275 Ancient x 13 rnd @ 1.16
Federal - .300 Win Mag x 30 rnd @ 1.94
Hornady - .7mm Rem Mag x 5 rnd @ 1.86
RWS - .7mm Rem Mag x 19 rnd @ 1.86
Barnes - .416 Ancient x 10 rnd @ 8.03

Range ammunition used on 17/09/2022",-Split-,423.62,"1,167,255.55"
,14/10/2022,Ledger Entry,3287,,"Norma - 7.5x55 x 169 rnd @ 2.03
Barnes .416 Ancient x 40 rnd @ 8.03
Ancient - .416 Ancient No 2 x 6 rnd @ 9.72
Ancient - .275 Ancient x 13 rnd @ 1.16

Range ammunition used on 10/09/2022",-Split-,737.67,"1,167,993.22"
,14/10/2022,Ledger Entry,3287,,"Hornady - .416 Ancient x 13 rnd @ 3.69
Barnes - .416 Ancient x 11 rnd @ 8.04
Federal - .300 Win Mag x 14 rnd @ 1.94
Ancient - .275 Ancient x 20 rnd @ 1.16
Federal - .308 win x 10 rnd @ 1.28
CCI - .22LR x 50 rnd @ 0.05

Range ammunition used on 19/08/2022",-Split-,201.96,"1,168,195.18"
,14/10/2022,Ledger Entry,3287,,"Hornady - .470 NE x 40 rnd @ 6.68
Barnes - .416 Ancient x 13 rnd @ 8.03
Ancient - .275 Ancient x 12 rnd @ 1.16
Hornady - 9.3x62 x 8 rnd @ 1.57

Range ammunition used on 12/08/2022",-Split-,398.07,"1,168,593.25"
,14/10/2022,Ledger Entry,3287,,"Hornady - .375 H&H x 16 rnd @ 2.79
Federal - .375 H&H x 26 rnd @ 3.07
Federal - .308 Win x 10 rnd @ 1.28
Hornady - .30-06 x 8 rnd @ 1.25
Federal - .303 x 5 rnd @ 1.46
Federal - .300 Win mag x 11 rnd @ 1.94
Ancient - .416 Ancient No. 2 x 34 @ 9.72

Range ammunition used on 14/07/2022",-Split-,506.38,"1,169,099.63"
,14/10/2022,Ledger Entry,3287,,"Hornady - .450 Ancient x 41 rnd @ 3.69
Ancient - .350 Ancient x 50 rnd @ 7.17
Federal - .300 Win Mag x 20 rnd @ 1.94
Hornady - .416 Ancient x 36 rnd @ 3.69
Federal - 7x57 x 20 rnd @ 1.26
Ancient - .275 Ancient x 20 rnd @ 1.16

Range ammunition used on 30/06/2022",-Split-,729.83,"1,169,829.46"
,14/10/2022,Ledger Entry,3288,,Barrels used in the production of 26 Swiss limited edition rifles,-Split-,"4,844.32","1,174,673.78"
,14/10/2022,Ledger Entry,3287,,"Ancient - .416 Ancient No.2 x 32 rnd @ 9.72
Ancient - .275 Ancient x 6 rnd @ 1.16
Federal - 7x57 x 26 rnd @ 1.26
Hornady - .416 Ancient x 16 rnd @ 3.69
Norma - .30-06 x 3 rnd @ 2.01
Hornady - .30-06 x 20 rnd @ 1.23

Range ammunition used on 09/06/2022",-Split-,440.43,"1,175,114.21"
,14/10/2022,Ledger Entry,3289,,Two wood blanks from Romain Lepinois used before he issued the Receipt,-Split-,"1,800.00","1,176,914.21"
,15/10/2022,Expense,,SASU BYG France,"Ancient sunglases Cape Buffalo Horn - 1,600 EUR",Payables,"1,414.42","1,178,328.63"
,18/10/2022,Expense,15.2,T & D O'Neill,Pick up and colections,Payables,860,"1,179,188.63"
,21/10/2022,Expense,103149,SRS Freight Ltd,Customs fees,Payables,"3,592.18","1,182,780.81"
,22/10/2022,Ledger Entry,3292,,being released from accrual s/n 18699,-Split-,-46,"1,182,734.81"
,22/10/2022,Ledger Entry,3292,,being released from accrual s/n 18699,-Split-,0.1,"1,182,734.91"
,25/10/2022,Expense,1965,TimberLake Workshop,Data set up fee,Payables,45,"1,182,779.91"
,25/10/2022,Expense,1965,TimberLake Workshop,laser engraving EU spec mark,Payables,12,"1,182,791.91"
,25/10/2022,Expense,1965,TimberLake Workshop,Import mark custom,Payables,78,"1,182,869.91"
,28/10/2022,Ledger Entry,3310,,S2M1FT0378,-Split-,0.03,"1,182,869.94"
,28/10/2022,Ledger Entry,3310,,S2M1FT1723,-Split-,109.38,"1,182,979.32"
,28/10/2022,Ledger Entry,3310,,S2M1FT1735,-Split-,55.74,"1,183,035.06"
,28/10/2022,Ledger Entry,3310,,S2M1FT0288,-Split-,11.62,"1,183,046.68"
,28/10/2022,Ledger Entry,3310,,S2M1FT0300,-Split-,2,"1,183,048.68"
,28/10/2022,Ledger Entry,3310,,S2M1FT0212,-Split-,56.47,"1,183,105.15"
,28/10/2022,Ledger Entry,3310,,S2M1FT2193,-Split-,7.03,"1,183,112.18"
,28/10/2022,Ledger Entry,3310,,S2M1FT0219,-Split-,39.59,"1,183,151.77"
,28/10/2022,Ledger Entry,3310,,S2M1FT0189,-Split-,16.3,"1,183,168.07"
,28/10/2022,Ledger Entry,3310,,S2M1FT0215,-Split-,40.35,"1,183,208.42"
,28/10/2022,Ledger Entry,3310,,S2M1FT0212,-Split-,56.47,"1,183,264.89"
,28/10/2022,Ledger Entry,3310,,S2M1FT1724,-Split-,41.67,"1,183,306.56"
,28/10/2022,Ledger Entry,3310,,S2M1FT0451,-Split-,9.96,"1,183,316.52"
,28/10/2022,Ledger Entry,3310,,S2M1FT1007,-Split-,612,"1,183,928.52"
,30/10/2022,Ledger Entry,3326,,Being released to P&L,-Split-,"248,500.13","1,432,428.65"
,31/10/2022,Ledger Entry,3328,,WBC  bags,-Split-,376.67,"1,432,805.32"
,31/10/2022,Ledger Entry,3327,,Being accrual for Swiss edition,-Split-,"16,000.00","1,448,805.32"
,31/10/2022,Ledger Entry,3328,,Harper office Packing Oct 2021,-Split-,350,"1,449,155.32"
,31/10/2022,Bank Draft,1401,,Gold,Business Card,16.45,"1,449,171.77"
,31/10/2022,Ledger Entry,3327,,Being stock Fund Transfer to P&L accessories sale,-Split-,"10,487.95","1,459,659.72"
,31/10/2022,Ledger Entry,3327,,Being accrual for 19601,-Split-,"6,500.00","1,466,159.72"
,1/11/2022,Expense,2.11E+13,Northwood Group UK Vendor,Northwood choke key - 20 bore,Payables,52,"1,466,211.72"
,1/11/2022,Expense,600673,Traditional English Guncases Ltd,Lightweight leather case for Dan Fraser,Payables,"1,500.00","1,467,711.72"
,1/11/2022,Expense,2553,Arms Restoration Services,Partial tooling charge for new tooling,Payables,300,"1,468,011.72"
,1/11/2022,Expense,2553,Arms Restoration Services,Two off 577 barrel blanks Ser No. 5707 with L/H twist and 5108 with R/H twist @ £380.oo,Payables,740,"1,468,751.72"
,2/11/2022,Expense,1896,John Dickson & Son Ltd,"Fraser Oil bottle with castle motif, set of 3 horn handled turnscrews, Mackintosh sling, .303 snap-cap",Payables,505,"1,469,256.72"
,8/11/2022,Expense,600665,Traditional English Guncases Ltd,Alteration to 10 cases,Payables,300,"1,469,556.72"
,8/11/2022,Expense,600665,Traditional English Guncases Ltd,16 x Swiss canvas leather,Payables,"14,400.00","1,483,956.72"
,9/11/2022,Expense,103227,SRS Freight Ltd,Import documentation,Payables,"2,694.70","1,486,651.42"
,12/11/2022,Expense,1986,TimberLake Workshop,Engraving,Payables,50,"1,486,701.42"
,12/11/2022,Expense,1986,TimberLake Workshop,Gordy and sons Vector development (1 off),Payables,80,"1,486,781.42"
,12/11/2022,Expense,1986,TimberLake Workshop,Steel plate design and fabrication,Payables,80,"1,486,861.42"
,19/11/2022,Expense,1432,Broadbent Leather goods,"Shooting book in blue croc-print leather, blocking: Stewart Craig",Payables,82.75,"1,486,944.17"
,19/11/2022,Expense,OP/I784116,GMK,7 X 64 SAKO HAMMERHEAD,Payables,96,"1,487,040.17"
,26/11/2022,Expense,Rig003,Ian Moran,Agreed training / tooling,Payables,"2,500.00","1,489,540.17"
,26/11/2022,Expense,103278,SRS Freight Ltd,Import documentation,Payables,631.6,"1,490,171.77"
,26/11/2022,Expense,2003,TimberLake Workshop,Replacement sheath,Payables,30,"1,490,201.77"
,29/11/2022,Expense,600674,Traditional English Guncases Ltd,Bespoke draw insert for Ancient 110 defender track,Payables,"2,750.00","1,492,951.77"
,30/11/2022,Ledger Entry,3362,,Being accrual for s/n 7306 M,-Split-,"2,500.00","1,495,451.77"
,30/11/2022,Ledger Entry,3362,,Being accrual for s/n 18725,-Split-,"3,000.00","1,498,451.77"
,30/11/2022,Ledger Entry,3362,,Being accrual for s/n 7070,-Split-,"8,000.00","1,506,451.77"
,30/11/2022,Ledger Entry,3362,,Being accrual for s/n 18785,-Split-,"3,500.00","1,509,951.77"
,30/11/2022,Ledger Entry,3362,,Being accrual for s/n 7067,-Split-,"1,000.00","1,510,951.77"
,30/11/2022,Ledger Entry,3362,,Being accrual for s/n 7250M,-Split-,"2,500.00","1,513,451.77"
,30/11/2022,Ledger Entry,3362,,Swiss canvas reversal,-Split-,"-15,000.00","1,498,451.77"
,30/11/2022,Bank Draft,1486,,cookson gold,Business Card,388.13,"1,498,839.90"
,30/11/2022,Ledger Entry,3362,,being released to P & L,-Split-,"221,117.51","1,719,957.41"
,30/11/2022,Ledger Entry,3348,,S2M1FT1185,-Split-,"1,347.43","1,721,304.84"
,30/11/2022,Ledger Entry,3348,,S2M1FT2010,-Split-,0,"1,721,304.84"
,30/11/2022,Ledger Entry,3348,,S2M1FT2010,-Split-,0,"1,721,304.84"
,30/11/2022,Ledger Entry,3348,,S2M1FT1819,-Split-,12.8,"1,721,317.64"
,30/11/2022,Ledger Entry,3348,,S2M1FT2284,-Split-,0,"1,721,317.64"
,30/11/2022,Ledger Entry,3348,,S2M1FT2009,-Split-,0,"1,721,317.64"
,30/11/2022,Ledger Entry,3348,,S2M1FT0300,-Split-,2,"1,721,319.64"
,30/11/2022,Ledger Entry,3348,,S2M1FT2139,-Split-,3.5,"1,721,323.14"
,30/11/2022,Ledger Entry,3348,,S2M1FT2126,-Split-,2.01,"1,721,325.15"
,30/11/2022,Ledger Entry,3348,,S2M1FT0694,-Split-,116,"1,721,441.15"
,30/11/2022,Ledger Entry,3348,,S2M1FT1945,-Split-,12,"1,721,453.15"
,30/11/2022,Ledger Entry,3348,,S2M1FT0309,-Split-,2,"1,721,455.15"
,30/11/2022,Ledger Entry,3348,,S2M1FT1935,-Split-,0,"1,721,455.15"
,30/11/2022,Ledger Entry,3348,,S2M1FT1946,-Split-,6,"1,721,461.15"
,30/11/2022,Ledger Entry,3348,,S2M1FT0331,-Split-,38.41,"1,721,499.56"
,30/11/2022,Ledger Entry,3348,,S2M1FT2324,-Split-,1.85,"1,721,501.41"
,30/11/2022,Ledger Entry,3348,,S2M1FT2019,-Split-,15.71,"1,721,517.12"
,30/11/2022,Ledger Entry,3348,,S2M1FT2007,-Split-,16.22,"1,721,533.34"
,30/11/2022,Ledger Entry,3348,,S2M1FT2323,-Split-,2.45,"1,721,535.79"
,30/11/2022,Ledger Entry,3348,,S2M1FT2004,-Split-,29.9,"1,721,565.69"
,30/11/2022,Ledger Entry,3348,,S2M1FT1996,-Split-,32.55,"1,721,598.24"
,30/11/2022,Ledger Entry,3348,,S2M1FT2018,-Split-,14.57,"1,721,612.81"
,30/11/2022,Ledger Entry,3364,,WBC  bags,-Split-,376.67,"1,721,989.48"
,30/11/2022,Ledger Entry,3364,,Harper office Packing Nov 2021,-Split-,350,"1,722,339.48"
,30/11/2022,Ledger Entry,3362,,Being Accessories c ost Fund Transfer to cost of sale,-Split-,"4,376.21","1,726,715.69"
,1/12/2022,Expense,600626,Traditional English Guncases Ltd,"Tan leather cases for Ancient Defenders
2 per: RR1, RG4, DM1",Payables,"3,333.33","1,730,049.02"
,1/12/2022,Expense,600644,Traditional English Guncases Ltd,"Re Tim Blane Smith 
Supplied slip embossed W.G. LE B. S",Payables,75,"1,730,124.02"
,1/12/2022,Expense,40,Royal,Export cost for N467 EOR,Payables,"4,650.72","1,734,774.74"
,1/12/2022,Expense,76307,Kerast,Vacuum annealed,Payables,175,"1,734,949.74"
,1/12/2022,Expense,76398,Kerast,Vacuum annealed,Payables,175,"1,735,124.74"
,1/12/2022,Expense,76398,Kerast,Vacuum annealed,Payables,175,"1,735,299.74"
,1/12/2022,Expense,19.2,T & D O'Neill,Pick up and collections - 01 Dec 21,Payables,240,"1,735,539.74"
,1/12/2022,Expense,76398,Kerast,Nitride - 18785,Payables,425,"1,735,964.74"
,1/12/2022,Expense,76398,Kerast,Case hardened - 18785,Payables,475,"1,736,439.74"
,1/12/2022,Expense,10221,Shooting Star,RC HPF3,Payables,"2,750.00","1,739,189.74"
,1/12/2022,Expense,16.2,T & D O'Neill,Pick up and collections - 26 Oct 21,Payables,188,"1,739,377.74"
,1/12/2022,Expense,17.2,T & D O'Neill,Pick up and collections - 22 Nov 21,Payables,220,"1,739,597.74"
,1/12/2022,Expense,18/2022,T & D O'Neill,Pick up and collections - 30 Nov 21,Payables,220,"1,739,817.74"
,1/12/2022,Expense,76398,Kerast,Vacuum annealed,Payables,225,"1,740,042.74"
,6/12/2022,Expense,44809,The Company of Gunmakers,0 .275 Ancient B/A RIFLE INSTANT PROOF,Payables,45.83,"1,740,088.57"
,8/12/2022,Expense,111288,A.S.I Ltd,repair of AYA 474-05 belonging to Allan Yarrow,Payables,129,"1,740,217.57"
,9/12/2022,Ledger Entry,3366,,being released to P&L,-Split-,1.5,"1,740,219.07"
,9/12/2022,Ledger Entry,3366,,being released to P&L s/n 18707,-Split-,50,"1,740,269.07"
,9/12/2022,Ledger Entry,3366,,being released to P&L s/n 14816,-Split-,39.62,"1,740,308.69"
,9/12/2022,Ledger Entry,3366,,being released to P&L,-Split-,3,"1,740,311.69"
,10/12/2022,Expense,1001/00089956,Edgar Brothers,"6.5 X 55 Swedish 140gr SST SPF
 HORN-85507",Payables,53.76,"1,740,365.45"
,13/12/2022,Expense,20.2,T & D O'Neill,Pick up and collections - 20 Dec 21,Payables,220,"1,740,585.45"
,14/12/2022,Expense,2.11E+13,Northwood Group UK Vendor,Northwood R8 Success / Ultimate Trigger Unit,Payables,279,"1,740,864.45"
,15/12/2022,Ledger Entry,3370,,"DMC 600 NE x 2 @ 4.15
DMC 600 NE x 9 @ 4.25

Range ammunition used on 24/11/21",-Split-,46.55,"1,740,911.00"
,15/12/2022,Ledger Entry,3370,,"DMC 600 NE x 2 @ 4.15
DMC 600 NE x 8 @ 4.25
Federal 416 Ancient x 9 @ 7.03
Federal 30-06 x 7 @ 0.85
Norma 30-06 x 7 @ 2.01

Range ammunition used on 19/11/21",-Split-,125.59,"1,741,036.59"
,15/12/2022,Ledger Entry,3370,,"Hornady 450 3 & 1/4"" x 11 @ 3.69

Range ammunition used on 16/11/21",-Split-,40.59,"1,741,077.18"
,15/12/2022,Ledger Entry,3370,,"Federal 22-250 x 28 @ 0.65
Federal 30-06 x 32 @ 0.99
Ancient 275 Ancient x 35 @ 1.16
DMC 600 NE x 15 @ 4.15

Range ammunition used on 14/12/21",-Split-,152.73,"1,741,229.91"
,15/12/2022,Ledger Entry,3370,,"Norma 7.5x55 x 220 rnd @ 2.03
Hornady 9.3x62 x 20 rnd @ 1.57
Hornady 375 H&H x 16 rnd @ 2.69
Hornady 450 Ancient x 4 @ 3.69

Range ammunition used on 22/10/21",-Split-,535.8,"1,741,765.71"
,15/12/2022,Ledger Entry,3370,,"Hornady 375 H&H x 24 @ 2.69
Federal 416 Ancient x 24 @ 7.03
Federal 375 H&H x 20 @ 4.52
Ancient 275 Ancient x 60 @ 1.16
Ancient 416 No. 2 x 9 @ 9.72
Ancient 416 No. 2 x 8 @ 9.72

Range ammunition used on 29/11/21",-Split-,558.52,"1,742,324.23"
,15/12/2022,Ledger Entry,3370,,"Federal 30-06 x 20 @ 1.45
Federal 416 Ancient x 8 @ 8.85
Ancient 275 Ancient x 8 @ 1.16
Federal 30-06 x 35 @ 0.99
Federal 375 H&H x 17 @ 4.52

Range ammunition used on 10/12/21",-Split-,220.57,"1,742,544.80"
,15/12/2022,Ledger Entry,3370,,"Hornady 450 Ancient x 7 @ 3.69
Federal 30-06 x 18 @ 0.85
Hornady 30-06 x 20 @ 1.25
Hornady 470 NE x 8 @ 6.68
Federal 470 NE x 4 @ 9.46

Range ammunition used on 13/10/21",-Split-,157.41,"1,742,702.21"
,16/12/2022,Expense,35,Steve Kelly,Silver inlay special design colt knob to Andy Miles pattern,Payables,450,"1,743,152.21"
,17/12/2022,Ledger Entry,3373,,S2M1FT2139,-Split-,7,"1,743,159.21"
,17/12/2022,Ledger Entry,3373,,S2M1FT0184,-Split-,38.51,"1,743,197.72"
,17/12/2022,Ledger Entry,3373,,S2M1FT0392,-Split-,0.16,"1,743,197.88"
,17/12/2022,Ledger Entry,3373,,S2M1FT0331,-Split-,38.41,"1,743,236.29"
,17/12/2022,Ledger Entry,3373,,S2M1FT0331,-Split-,38.41,"1,743,274.70"
,17/12/2022,Ledger Entry,3373,,S2M1FT0285,-Split-,11.62,"1,743,286.32"
,17/12/2022,Ledger Entry,3373,,S2M1FT0273,-Split-,2,"1,743,288.32"
,17/12/2022,Ledger Entry,3373,,S2M1FT0273,-Split-,2,"1,743,290.32"
,17/12/2022,Ledger Entry,3373,,S2M1FT0273,-Split-,2,"1,743,292.32"
,17/12/2022,Ledger Entry,3373,,S2M1FT0271,-Split-,2,"1,743,294.32"
,17/12/2022,Ledger Entry,3373,,S2M1FT0271,-Split-,2,"1,743,296.32"
,17/12/2022,Ledger Entry,3373,,S2M1FT2185,-Split-,2.4,"1,743,298.72"
,17/12/2022,Ledger Entry,3373,,S2M1FT2185,-Split-,2.4,"1,743,301.12"
,17/12/2022,Ledger Entry,3373,,S2M1FT2139,-Split-,7,"1,743,308.12"
,22/12/2022,Expense,,Shooting Star,RC HPF3,Payables,39.5,"1,743,347.62"
,27/12/2022,Expense,21025202,Ben Becker,transport - 969 Eur,Payables,821.2,"1,744,168.82"
,30/12/2022,Vendor Credit,21247256,Swarovski Optik,The credit is the annual retro bonus given.,Payables,-732.49,"1,743,436.33"
,31/12/2022,Ledger Entry,3417,,being accessories cost Fund Transfer to P&L,-Split-,"7,952.28","1,751,388.61"
,31/12/2022,Expense,22.2,T & D O'Neill,Pick up and collections - 20 Dec 21,Payables,160,"1,751,548.61"
,31/12/2022,Expense,21.2,T & D O'Neill,Pick up and collections - 15 Dec 21,Payables,160,"1,751,708.61"
,31/12/2022,Expense,37595,Irons Brothers Ltd,1 Off  Cast Iron Garrison Gun Carriage to suit:,Payables,"5,200.00","1,756,908.61"
,31/12/2022,Expense,37595,Irons Brothers Ltd,"1 Off  Armstrong 9 Pounder from new pattern, R R Insignia",Payables,"4,480.00","1,761,388.61"
,31/12/2022,Ledger Entry,3424,,year end adjustment after stock count,-Split-,"41,925.76","1,803,314.37"
,31/12/2022,Ledger Entry,3419,,Iron Brothers cannon Receipt being Fund Transferred to preTransaction,-Split-,"5,200.00","1,808,514.37"
,31/12/2022,Ledger Entry,3419,,Iron Brothers cannon Receipt being Fund Transferred to preTransaction,-Split-,"4,480.00","1,812,994.37"
,31/12/2022,Ledger Entry,3418,,being accrual for   18709 for Johnson Receipt,-Split-,500,"1,813,494.37"
,31/12/2022,Ledger Entry,3418,,being accrual for case accessories  7109,-Split-,"1,455.00","1,814,949.37"
,31/12/2022,Ledger Entry,3418,,being accrual for case accessories  7110,-Split-,"1,455.00","1,816,404.37"
,31/12/2022,Bank Draft,1402,,National shooting,Business Card,3.3,"1,816,407.67"
,31/12/2022,Bank Draft,1402,,the gun trade ass,Business Card,14,"1,816,421.67"
,31/12/2022,Ledger Entry,3405,,Els and Co - Export permit (Expense 13986),-Split-,153.33,"1,816,575.00"
,31/12/2022,Ledger Entry,3403,,"Hibo - 1.A4 leather folder, with two
pieces
genuine leather sewing
together(sewing bottom and
left side)
2.Emboss Logo($4180)",-Split-,"2,957.35","1,819,532.35"
,31/12/2022,Ledger Entry,3403,,"Hibo - 1.Gun Socks
2.Embroidery Ancient logon on
it($730)",-Split-,516.47,"1,820,048.82"
,31/12/2022,Ledger Entry,3421,,WBC  bags,-Split-,376.67,"1,820,425.49"
,31/12/2022,Ledger Entry,3417,,WIP cost being released to P&L,-Split-,"222,307.80","2,042,733.29"
,31/12/2022,Ledger Entry,3421,,Harper office Packing Dec 2021,-Split-,350,"2,043,083.29"
,31/12/2022,Ledger Entry,3404,,WBC - Dumpy Bottle Pulpsafe Transit Pack,-Split-,30.24,"2,043,113.53"
,31/12/2022,Ledger Entry,3425,,Accrual for Rifles being reversed,-Split-,"-29,401.77","2,013,711.76"
Total for Cost of sales,,,,,,,"£2,013,711.76  ",
Materials & Tools,,,,,,,,
,4/1/2022,Bank Draft,Mary1223,guntrader.co.uk,tools,EastX ****2310,14.5,14.5
,31/01/2022,Bank Draft,766,,workshop tools,Business Card,10.7,25.2
,31/01/2022,Bank Draft,766,,Workshop tools,Business Card,9.15,34.35
,31/01/2022,Bank Draft,766,,Albert Haywood Tools,Business Card,124.9,159.25
,31/01/2022,Bank Draft,765,,workshop tools,Business Card,11.99,171.24
,31/01/2022,Bank Draft,767,,Workshop  supply,Business Card,17.9,189.14
,31/01/2022,Bank Draft,766,,tools,Business Card,21.16,210.3
,31/01/2022,Bank Draft,766,,workshop tools,Business Card,19.58,229.88
,31/01/2022,Bank Draft,766,,workshop tools,Business Card,19.08,248.96
,31/01/2022,Bank Draft,766,,workshop tools,Business Card,10.79,259.75
,31/01/2022,Bank Draft,767,,workshop tools,Business Card,58.22,317.97
,31/01/2022,Bank Draft,767,,workshop tools,Business Card,6.3,324.27
,31/01/2022,Bank Draft,767,,workshop tools,Business Card,8.39,332.66
,31/01/2022,Bank Draft,766,,tools,Business Card,54.42,387.08
,1/2/2022,Bank Draft,Mary1294,guntrader.co.uk,,EastX ****2310,14.5,401.58
,5/2/2022,Expense,76448,Mike Ball,Wet & Dry sandpaper,Payables,732.7,"1,134.28"
,9/2/2022,Expense,67233,Sharmic Engineering Limited,Blacking salts,Payables,273.75,"1,408.03"
,28/02/2022,Bank Draft,792,,tools,Business Card,85.57,"1,493.60"
,28/02/2022,Bank Draft,775,,workshop tools,Business Card,97.25,"1,590.85"
,28/02/2022,Bank Draft,775,,workshop tools,Business Card,24.5,"1,615.35"
,28/02/2022,Bank Draft,779,,workshop tools,Business Card,84,"1,699.35"
,28/02/2022,Bank Draft,775,,Workshop tools,Business Card,8.5,"1,707.85"
,28/02/2022,Bank Draft,778,,Workshop tools,Business Card,27.8,"1,735.65"
,28/02/2022,Bank Draft,778,,Workshop,Business Card,22.99,"1,758.64"
,28/02/2022,Bank Draft,777,,Workshop tools,Business Card,9.99,"1,768.63"
,28/02/2022,Bank Draft,777,,Workshop tools,Business Card,11.75,"1,780.38"
,28/02/2022,Bank Draft,790,,workshop tools,Business Card,149.76,"1,930.14"
,28/02/2022,Bank Draft,789,,Tools,Business Card,27.87,"1,958.01"
,28/02/2022,Bank Draft,787,,workshop tools,Business Card,7.55,"1,965.56"
,28/02/2022,Bank Draft,786,,workshop tools,Business Card,12.98,"1,978.54"
,28/02/2022,Bank Draft,784,,workshop tools,Business Card,17.75,"1,996.29"
,28/02/2022,Bank Draft,783,,tools,Business Card,48,"2,044.29"
,28/02/2022,Bank Draft,785,,workshop tools,Business Card,21.9,"2,066.19"
,28/02/2022,Bank Draft,775,,workshop tools,Business Card,22.95,"2,089.14"
,1/3/2022,Expense,109489-1,BrandCo Branding Ltd,300 ml Orbit Crystalite High ball,Payables,265.16,"2,354.30"
,11/3/2022,Expense,INV62078,ASIC S A of Switzerland,Tools,Payables,964.29,"3,318.59"
,23/03/2022,Expense,,Mark Remmant,Silver (inlaying) rifle 7076,Payables,30,"3,348.59"
,26/03/2022,Expense,6569,GD Machinery Ltd,"Abwood tilting vice, Jones& Shipman tilting vice",Payables,250,"3,598.59"
,31/03/2022,Bank Draft,801,,workshop tools,Business Card,12.12,"3,610.71"
,31/03/2022,Bank Draft,873,,Workshop tool,Business Card,4.98,"3,615.69"
,31/03/2022,Bank Draft,821,,workshop material,Business Card,4.98,"3,620.67"
,31/03/2022,Bank Draft,849,,Grinding machine,Business Card,57.12,"3,677.79"
,31/03/2022,Bank Draft,806,,Albert Hywood,Business Card,49.9,"3,727.69"
,31/03/2022,Bank Draft,842,,Oil wood,Business Card,10.37,"3,738.06"
,31/03/2022,Bank Draft,812,,workshop material,Business Card,31.25,"3,769.31"
,31/03/2022,Bank Draft,803,,workshop tools,Business Card,20.58,"3,789.89"
,31/03/2022,Bank Draft,845,,Workshop tools,Business Card,16.55,"3,806.44"
,31/03/2022,Bank Draft,804,,workshop tools,Business Card,25,"3,831.44"
,31/03/2022,Bank Draft,813,,workshop material,Business Card,42,"3,873.44"
,31/03/2022,Bank Draft,823,,workshop material,Business Card,10.68,"3,884.12"
,31/03/2022,Bank Draft,814,,workshop tools,Business Card,49.88,"3,934.00"
,31/03/2022,Bank Draft,854,,DIY Grinder Electric Belt Sander Mini DIY Polishing Grinding Machine,Business Card,47.54,"3,981.54"
,31/03/2022,Bank Draft,853,,HSS SLITTING SAW 20MM DIA X 0.5 MM WIDE 48 TEETH,Business Card,22.58,"4,004.12"
,31/03/2022,Bank Draft,799,,workshop material,Business Card,11.88,"4,016.00"
,31/03/2022,Bank Draft,800,,Workshop tools,Business Card,14.08,"4,030.08"
,31/03/2022,Bank Draft,822,,material tools,Business Card,5.5,"4,035.58"
,31/03/2022,Bank Draft,816,,Tools,Business Card,14.58,"4,050.16"
,31/03/2022,Bank Draft,855,,Trade Secret Oil Finish Kit Shotgun Wooden Stocks Airguns,Business Card,354.38,"4,404.54"
,31/03/2022,Bank Draft,802,,workshop tools,Business Card,18.33,"4,422.87"
,4/4/2022,Bank Draft,Mary1487,guntrader.co.uk,tools,EastX ****2310,14.5,"4,437.37"
,21/04/2022,Expense,133,Paua Trading Limited,Paua extreme 4 layer/10mm 3 sheets,Payables,350,"4,787.37"
,28/04/2022,Expense,26563,Alan Rhone lTD,Trade secret TS95 Oil,Payables,10.42,"4,797.79"
,29/04/2022,Bank Draft,875,,workshop material,Business Card,69.95,"4,867.74"
,30/04/2022,Bank Draft,894,,metal workshop tool,Business Card,58.06,"4,925.80"
,30/04/2022,Bank Draft,892,,Brush on engine machines,Business Card,21.56,"4,947.36"
,30/04/2022,Bank Draft,894,,vidaXL Clamping Set 58 Pieces Steel T Slot M12 Universal Combination Fixture(,Business Card,72.49,"5,019.85"
,30/04/2022,Bank Draft,889,,tools,Business Card,16.76,"5,036.61"
,30/04/2022,Bank Draft,889,,tools,Business Card,53.8,"5,090.41"
,30/04/2022,Bank Draft,893,,sand paper,Business Card,24.49,"5,114.90"
,30/04/2022,Bank Draft,893,,"Brass Shim Sheet (CZ108) 6"" x 2 1/2"" Rectangle",Business Card,19.95,"5,134.85"
,30/04/2022,Bank Draft,895,,Bandsaw blade workshop tools,Business Card,62.01,"5,196.86"
,30/04/2022,Bank Draft,892,,workshop material,Business Card,56,"5,252.86"
,30/04/2022,Bank Draft,892,,workshop material,Business Card,9.71,"5,262.57"
,30/04/2022,Bank Draft,892,,tools,Business Card,23.44,"5,286.01"
,30/04/2022,Bank Draft,894,,LED Strip 220V 240V 5050 SMD 60LED/M Waterproof Tape Lights Rope With Plug,Business Card,6.33,"5,292.34"
,30/04/2022,Bank Draft,893,,Workshop materoal,Business Card,77.2,"5,369.54"
,30/04/2022,Bank Draft,891,,Chemical solvent,Business Card,19.9,"5,389.44"
,30/04/2022,Bank Draft,891,,workshop tools,Business Card,19.94,"5,409.38"
,30/04/2022,Bank Draft,894,,workshop tools,Business Card,24.16,"5,433.54"
,31/05/2022,Bank Draft,966,,Maglite M2A016 Mini Mag AA Cell Torch in Blister Pack - Black,Business Card,13.36,"5,446.90"
,31/05/2022,Bank Draft,957,,Marcus Mccallum ltd,Business Card,70.8,"5,517.70"
,31/05/2022,Bank Draft,923,,workshop material,Business Card,10.72,"5,528.42"
,31/05/2022,Bank Draft,904,,sanding paper,Business Card,8.73,"5,537.15"
,31/05/2022,Bank Draft,900,,Sawn Treated Timber Regularised 47mm x 50mm x 4.8m Tray Kevin,Business Card,122.44,"5,659.59"
,31/05/2022,Bank Draft,906,,work shop material,Business Card,5.7,"5,665.29"
,31/05/2022,Bank Draft,924,,Silver steel ground shaft,Business Card,141.61,"5,806.90"
,31/05/2022,Bank Draft,964,,Gun components,Business Card,44.5,"5,851.40"
,31/05/2022,Bank Draft,977,,workshop material,Business Card,41.96,"5,893.36"
,31/05/2022,Bank Draft,954,,Metric Viton Rubber O Rings 2mm Cross Section 2mm-30mm ID,Business Card,5.34,"5,898.70"
,31/05/2022,Bank Draft,973,,woodwise uk,Business Card,23.45,"5,922.15"
,31/05/2022,Bank Draft,982,,Avlon gun limited,Business Card,268.1,"6,190.25"
,31/05/2022,Bank Draft,981,,Oil finish kit,Business Card,374.88,"6,565.13"
,31/05/2022,Bank Draft,941,,Wood frame,Business Card,8.87,"6,574.00"
,31/05/2022,Bank Draft,905,,tools,Business Card,4.99,"6,578.99"
,31/05/2022,Bank Draft,974,,Kennametal 6mm Solid Carbide Slot Drill End Mill KC643M - 3 Flute -,Business Card,25.62,"6,604.61"
,31/05/2022,Bank Draft,902,,gas cylinder,Business Card,66.55,"6,671.16"
,31/05/2022,Bank Draft,929,,tools,Business Card,9.18,"6,680.34"
,31/05/2022,Bank Draft,907,,workshop material,Business Card,5.99,"6,686.33"
,31/05/2022,Bank Draft,946,,Bridge port R8 Vertex,Business Card,17.24,"6,703.57"
,31/05/2022,Bank Draft,967,,oil finish shotgun wood stock,Business Card,129.75,"6,833.32"
,31/05/2022,Bank Draft,944,,gun components,Business Card,66,"6,899.32"
,31/05/2022,Bank Draft,948,,Imperial Ground Flat Stock Gauge Plate.O1 GFS,Business Card,31.24,"6,930.56"
,1/6/2022,Bank Draft,Mary1615,guntrader.co.uk,tools,EastX ****2310,14.5,"6,945.06"
,14/06/2022,Vendor Credit,,BrandCo Branding Ltd,"Debit Memo against Receipt no 109489-1
WSIP cost",Payables,-265.16,"6,679.90"
,30/06/2022,Bank Draft,1028,,"NEW Bright Mild Steel Flat Bar - 150mm Wide x 10mm,12,16,20,30,40 & 50mm Thick",Business Card,17.67,"6,697.57"
,30/06/2022,Bank Draft,1017,,"RDGTOOLS SET OF 6 TITANIUM COATED CENTRE DRILL SET METAL LATHE WORKING TOOLS(290442883357)
Royal Mail 48",Business Card,21.5,"6,719.07"
,30/06/2022,Bank Draft,1005,,workshop consumable,Business Card,43.96,"6,763.03"
,30/06/2022,Bank Draft,1016,,LOCTITE Super Glue - Precision Max - Extra Long Nozzle - 10g Bottle (191177572643,Business Card,51.15,"6,814.18"
,30/06/2022,Bank Draft,1041,,workshop tools,Business Card,11.74,"6,825.92"
,30/06/2022,Bank Draft,1018,,"PRESTO SET OF 4 CENTRE DRILLS BS1, BS2, BS3, BS4 METAL LATHE WORKING TOOLS(352851526780)
Royal Mail 2ndClass
£23.00
Item(",Business Card,23,"6,848.92"
,30/06/2022,Bank Draft,1008,,Workshop material,Business Card,20.07,"6,868.99"
,30/06/2022,Bank Draft,1020,,material tools,Business Card,30.1,"6,899.09"
,30/06/2022,Bank Draft,999,,11PC R8 METRIC ROUNDROUND COLLET,Business Card,63.05,"6,962.14"
,30/06/2022,Bank Draft,1050,,workshop consumable,Business Card,12.34,"6,974.48"
,30/06/2022,Bank Draft,1001,,Workshop tools,Business Card,19.95,"6,994.43"
,30/06/2022,Bank Draft,1019,,workshop tools,Business Card,55.3,"7,049.73"
,30/06/2022,Bank Draft,1007,,workshop tools,Business Card,42.35,"7,092.08"
,30/06/2022,Bank Draft,1024,,"10"" x 8"" Cast Iron Tilting Angle Plate Bracket 0°-90° Stripped & Serviced TAP9 (393271949730)",Business Card,200,"7,292.08"
,30/06/2022,Bank Draft,1006,,workshop consumable,Business Card,63,"7,355.08"
,30/06/2022,Bank Draft,1004,,workshop tools,Business Card,22.1,"7,377.18"
,30/06/2022,Bank Draft,990,,tools,Business Card,21.96,"7,399.14"
,30/06/2022,Bank Draft,1000,,Workshop consumable,Business Card,56,"7,455.14"
,30/06/2022,Bank Draft,1029,,VARIOUS SIZES OF ALUMINIUM FLAT BAR ExpenseETS SQUARE FLAT ENGINEERING BAR MILLING,Business Card,10.45,"7,465.59"
,30/06/2022,Bank Draft,1039,,workshop material,Business Card,22.99,"7,488.58"
,1/7/2022,Bank Draft,Mary1675,guntrader.co.uk,tools,EastX ****2310,14.5,"7,503.08"
,1/7/2022,Expense,40951,Irvine Springs Company Ltd,Spring clip,Payables,386,"7,889.08"
,13/07/2022,Expense,PRO/117309,BrandCo Branding Ltd,365ml Bubble Base High Ball - repeat order 113593,Payables,155,"8,044.08"
,13/07/2022,Expense,PRO/117309,BrandCo Branding Ltd,Origination,Payables,7.95,"8,052.03"
,13/07/2022,Expense,PRO/117309,BrandCo Branding Ltd,180ml Infinity Champagne Flute,Payables,163.4,"8,215.43"
,13/07/2022,Expense,PRO/117309,BrandCo Branding Ltd,Carriage,Payables,15.1,"8,230.53"
,13/07/2022,Expense,PRO/117309,BrandCo Branding Ltd,Origination,Payables,7.95,"8,238.48"
,31/07/2022,Bank Draft,1137,,Pin Vice English Pattern 4pcs Set Hobby Precision 0 to 4.8mm Chuck Holding size,Business Card,5.99,"8,244.47"
,31/07/2022,Bank Draft,1124,,Isopropyl Alcohol 99.9% PURE Isopropanol Lab Grade Rubbing IPA Disinfectant (164681801058,Business Card,13.38,"8,257.85"
,31/07/2022,Bank Draft,1138,,"Presto UK 1/2"" x 20tpi HSS UNF Second Tap / Direct from RDGTools (291762134099)",Business Card,12.52,"8,270.37"
,31/07/2022,Bank Draft,1109,,Extra Strong Black Nitrile Powder & Latex Free Disposable Gloves Tattoo Mechanic,Business Card,33,"8,303.37"
,31/07/2022,Bank Draft,1090,,Presto UK single metric drills HSS drill bit various sizes mm / From RDGTools (351600293009,Business Card,3.5,"8,306.87"
,31/07/2022,Bank Draft,1083,,"NEW Bright Mild Steel Flat Bar - 150mm Wide x 10mm,12,16,20,30,40 & 50mm Thick",Business Card,29.44,"8,336.31"
,31/07/2022,Bank Draft,1070,,JUN-AIR Compressor oil for Jun-Air compressors,Business Card,23.52,"8,359.83"
,31/07/2022,Bank Draft,1104,,Cookson Gold,Business Card,118,"8,477.83"
,31/07/2022,Bank Draft,1093,,"Presto HSCo Cobalt Jobber Drill 3/16"" 4.8mm 1, 2, 3, 5, 10 pcs (114189137063",Business Card,2.49,"8,480.32"
,31/07/2022,Bank Draft,1092,,Presto HSCO 8% Cobalt Jobber Drills 1 - 5.9mm (153528729696,Business Card,14.49,"8,494.81"
,31/07/2022,Bank Draft,1102,,Cookson Gold,Business Card,102.01,"8,596.82"
,31/07/2022,Bank Draft,1088,,"6.0mm - 6.99mm HSS-E
Machine Reamers",Business Card,39.95,"8,636.77"
,31/07/2022,Bank Draft,1089,,"Presto HSCo Cobalt Jobber Drill 3/16"" 4.8mm 1, 2, 3, 5, 10 pcs (114189137063",Business Card,2.59,"8,639.36"
,31/07/2022,Bank Draft,1091,,Presto HSCo Cobalt Super Elite Jobber Drill Bits 6.5mm *NEW* (114655063284,Business Card,4.5,"8,643.86"
,31/07/2022,Bank Draft,1084,,Face Mask Protective Covering Mouth Nose Masks UK x 50 Face Masks (254615204732,Business Card,19.55,"8,663.41"
,31/07/2022,Bank Draft,1123,,Methylated Spirit FUEL Burners Camping Stoves Clean Stain Removal 2L (284111694451,Business Card,25.9,"8,689.31"
,1/8/2022,Expense,910035900,Hoffmann Group,missing Expense,Payables,27.55,"8,716.86"
,1/8/2022,Expense,102,TRADE SECRET,ALKENET OIL 50ML,Payables,120,"8,836.86"
,1/8/2022,Expense,102,TRADE SECRET,RAPID OIL 500ML,Payables,120,"8,956.86"
,2/8/2022,Bank Draft,Mary1726,guntrader.co.uk,tools,EastX ****2310,14.5,"8,971.36"
,31/08/2022,Bank Draft,1212,,workshop material,Business Card,29.41,"9,000.77"
,31/08/2022,Bank Draft,1230,,4mm 5mm 6mm 8mm 10mm 12mm Stainless Steel Repair Washers Mudguard PennyFender,Business Card,2.49,"9,003.26"
,31/08/2022,Bank Draft,1270,,workshop tools,Business Card,4.85,"9,008.11"
,31/08/2022,Bank Draft,1273,,workshop[ material,Business Card,9.98,"9,018.09"
,31/08/2022,Bank Draft,1178,,workshop consumable,Business Card,6.68,"9,024.77"
,31/08/2022,Bank Draft,1175,,workshop consumable,Business Card,2.1,"9,026.87"
,31/08/2022,Bank Draft,1271,,workshop material,Business Card,6.08,"9,032.95"
,31/08/2022,Bank Draft,1180,,material tools,Business Card,16.99,"9,049.94"
,31/08/2022,Bank Draft,1179,,workshop tools,Business Card,13.96,"9,063.90"
,31/08/2022,Bank Draft,1265,,workshop material,Business Card,84.92,"9,148.82"
,31/08/2022,Bank Draft,1213,,workshop material,Business Card,36.95,"9,185.77"
,31/08/2022,Bank Draft,1197,,3/8 32 UNS Tap HSS Norman Spiral Flute (353447758326,Business Card,10,"9,195.77"
,31/08/2022,Bank Draft,1277,,710R Soft & Hard Faced Hammer Wood Handle 32mm 385g,Business Card,19.78,"9,215.55"
,31/08/2022,Bank Draft,1276,,6 Drawer Plain Wooden Storage Box Chest Cupboard with Drawers Decoupage BIG(,Business Card,29.99,"9,245.54"
,31/08/2022,Bank Draft,1231,,"Hysagtek 50x 5mm Metal Shelf Support Pins, Pug in Shelf Pegs Studs Hardware for Kitchen Cabinet Bookcase,",Business Card,4.99,"9,250.53"
,31/08/2022,Bank Draft,1207,,Presto HSCO 8% Cobalt Jobber Drills 1 - 5.9mm,Business Card,4.56,"9,255.09"
,31/08/2022,Bank Draft,1198,,Tegera 130A Tig Mig Leather Welding Heat Resistant Work Gloves S M L XL XXL (142122560634,Business Card,19.98,"9,275.07"
,31/08/2022,Bank Draft,1214,,CHEAP Bright Mild Steel EN3B Round Solid Metal Bar Rod 4mm-50mm Various Lengths,Business Card,44.1,"9,319.17"
,31/08/2022,Bank Draft,1196,,M4 M5 M6 M8 M10 M12 PENNY REPAIR WASHERS STAINLESS STEEL A2 304 MUDGUARDWASHERS,Business Card,5.29,"9,324.46"
,31/08/2022,Bank Draft,1242,,Busch Burr 1au Round 0.3 mm,Business Card,32.46,"9,356.92"
,31/08/2022,Bank Draft,1284,,Metric Silver Steel Round Bar - Round Ground Shaft Rod,Business Card,256.83,"9,613.75"
,31/08/2022,Ledger Entry,3245,,workshop material refund,-Split-,-11.75,"9,602.00"
,31/08/2022,Bank Draft,1177,,Customcard ltd¨ Black Security Lanyard with Black Security Badge Holder,Business Card,5.58,"9,607.58"
,1/9/2022,Expense,1649,Helston Gunsmiths,Parts,Payables,14.5,"9,622.08"
,23/09/2022,Expense,1921,TimberLake Workshop,Custom brass,Payables,15,"9,637.08"
,30/09/2022,Bank Draft,1329,,"6, 12 Blue Centre Feed Rolls 2ply Kitchen Roll Wiper Paper Towel-",Business Card,63,"9,700.08"
,30/09/2022,Bank Draft,1316,,White Lithium Grease Spray 400ml 3 in 1 Heavy Duty Lubricant Rust Protection,Business Card,19.99,"9,720.07"
,30/09/2022,Bank Draft,1330,,"9 x Rolls of Scotch / 3M 2120 / 101E Paper Masking Tape, 25mm x 50m, NoResidue",Business Card,51.96,"9,772.03"
,30/09/2022,Bank Draft,1309,,"HypaClens Sterile Eye Wash Pods, (Pack of 25)",Business Card,15.83,"9,787.86"
,30/09/2022,Bank Draft,1305,,"Small Carbide Cylinder Burrs (0.7mm - 2.30mm)
2.35mm shank
Size: 2.30mm",Business Card,19.17,"9,807.03"
,30/09/2022,Bank Draft,1290,,"Amazon Basics High-Speed, Ultra HD HDMI 2.0 Cable, Supports 3D",Business Card,4.16,"9,811.19"
,30/09/2022,Bank Draft,1302,,HypaClens Value Emergency Eye Wash Station (2 x 500ml,Business Card,8.04,"9,819.23"
,30/09/2022,Bank Draft,1315,,BARTOLINE METHYLATED SPIRIT,Business Card,37.78,"9,857.01"
,30/09/2022,Bank Draft,1324,,"Ikea FISKBO Frame 21 x 30 cm (BLACK, 20)",Business Card,176.08,"10,033.09"
,30/09/2022,Bank Draft,1294,,"Silverline TCT Circular Saw Blades, 180 x 30 - 20, 24, 40 Tooth Blades - 3Pack",Business Card,11.63,"10,044.72"
,30/09/2022,Bank Draft,1292,,Oasser Tyre Pressure Gauge Tyre Inflator with Pressure Gauge LCD,Business Card,21.99,"10,066.71"
,30/09/2022,Bank Draft,1331,,workshop consumable,Business Card,23.46,"10,090.17"
,30/09/2022,Bank Draft,1317,,Walter Prototyp 3mm Carbide End mill MC122-03.0A4B-WJ30TF Tialn4,Business Card,48,"10,138.17"
,30/09/2022,Bank Draft,1304,,Carbide End Mill 4 Flute 1mm - 20mm ALTiN Coated Slot Drill -Engineering Tools (143993834940,Business Card,18.6,"10,156.77"
,1/10/2022,Expense,16870,SAS Liogier- Allary,workshop tools - 304.94 EUR,Payables,265.16,"10,421.93"
,1/10/2022,Bank Draft,Mary1921,guntrader.co.uk,tools,EastX ****2310,14.5,"10,436.43"
,19/10/2022,Bank Draft,Mary1950,guntrader.co.uk,tools,EastX ****2310,29,"10,465.43"
,30/10/2022,Bank Draft,1350,,wet and dry sheet,Business Card,488.75,"10,954.18"
,30/10/2022,Bank Draft,1344,,Oil Colour,Business Card,32.28,"10,986.46"
,30/10/2022,Bank Draft,1361,,Phillips Gun Blue Paste 20g Jar Bluing Touch Up Repair Maintenance Gunsmith,Business Card,24.8,"11,011.26"
,31/10/2022,Bank Draft,1380,,workshop consumable,Business Card,24.99,"11,036.25"
,31/10/2022,Bank Draft,1372,,Professional 6L Digital Ultrasonic Cleaner Timer 304 Stainless Steel Cotainer UK,Business Card,73.33,"11,109.58"
,31/10/2022,Bank Draft,1397,,2 x Everbuild Raw Linseed Oil 500ml (254875214908),Business Card,8.33,"11,117.91"
,31/10/2022,Bank Draft,1396,,2 x Everbuild Raw Linseed Oil 500ml (254875214908),Business Card,8.29,"11,126.20"
,31/10/2022,Bank Draft,1378,,20mm x 8mm Black Mild Steel Flat,Business Card,12.21,"11,138.41"
,31/10/2022,Bank Draft,1400,,Workshop supplies,Business Card,52.5,"11,190.91"
,31/10/2022,Bank Draft,1386,,Bamboo Cotton Buds 3 Boxes (900 Buds) by Leaf boat | GOTS Certified Organic | Recycled Packaging Home Compostable,Business Card,22.48,"11,213.39"
,31/10/2022,Bank Draft,1410,,"Anti-fatigue non-slip mat SECURE, per
metre, W 910 mm, black, yellow",Business Card,74,"11,287.39"
,31/10/2022,Bank Draft,1374,,"Dremel 4000 Rotary Tool 175 W, Rotary Multi Tool Kit with 1 Attachment 45 Accessories Variable Speed 5000-35000 RPM for",Business Card,66.67,"11,354.06"
,31/10/2022,Bank Draft,1381,,packing boxes,Business Card,27.99,"11,382.05"
,31/10/2022,Bank Draft,1403,,Paking boxes,Business Card,72.54,"11,454.59"
,31/10/2022,Bank Draft,1379,,Rustins Wood Dye for Interior & Exterior 250ml 12 Colours to Choose From! (321712898473,Business Card,16.98,"11,471.57"
,31/10/2022,Ledger Entry,3329,,material tools returns,-Split-,-198,"11,273.57"
,31/10/2022,Bank Draft,1419,,Flogas-Dom,Business Card,99.6,"11,373.17"
,30/11/2022,Ledger Entry,3357,,"1L LITER VASELINE OIL Reduces friction, preserves the components and protects (124676791172) refund",-Split-,-43.96,"11,329.21"
,30/11/2022,Bank Draft,1449,,Cable Zip Ties [50 PACK] Nylon Wraps High Quality Strong 150mm/200mm/250mm/300mm (384104462683),Business Card,1.93,"11,331.14"
,30/11/2022,Ledger Entry,3358,,"50 ml VASELINE OIL Reduces friction, preserves the components and protects UK (393133801819) refund",-Split-,-44.9,"11,286.24"
,30/11/2022,Bank Draft,1490,,workshop consumable,Business Card,32.67,"11,318.91"
,30/11/2022,Bank Draft,1480,,3pc Mini Locking Plier Clamp Mole Vice Grip Pliers Welding Clasp C Clamp (142798239627),Business Card,6.99,"11,325.90"
,30/11/2022,Bank Draft,1520,,workshop consumable,Business Card,71.97,"11,397.87"
,30/11/2022,Bank Draft,1470,,IR Laser Infrared Thermometer Non Contact LCD Industrial Temperature Gun C/F UK (174899195986),Business Card,26.39,"11,424.26"
,30/11/2022,Bank Draft,1510,,workshop consumable,Business Card,151.98,"11,576.24"
,30/11/2022,Bank Draft,1479,,Short Handle Hog Hair Bristle Round Flat Artist Art Craft Paint Brush Many Sizes (123545744637),Business Card,2.5,"11,578.74"
,30/11/2022,Bank Draft,1489,,tools,Business Card,9.66,"11,588.40"
,30/11/2022,Bank Draft,1475,,Traxx 9011 38 x 14mm Scanned Self Inking Rubber Stamp (RED Ink) - Text is Bold Capital Letters for Inking Your Scanned,Business Card,11.95,"11,600.35"
,30/11/2022,Bank Draft,1457,,HUMBROL Enamel Model Paint - ALL COLOURS - Matt Gloss Satin 14ml airfix revell (333511598613) Royal Mail,Business Card,8.55,"11,608.90"
,30/11/2022,Bank Draft,1473,,"120ml can Armistol Gun Oil firearms, shotgun rifle pistol,Stop Rust & corrosion (324300849798) Royal Mail 48 £49.95
Items bought",Business Card,45.95,"11,654.85"
,30/11/2022,Bank Draft,1483,,"Duracell NEW Plus 9V Alkaline Batteries [Pack of 4], 6LR61 MN1604",Business Card,10.29,"11,665.14"
,30/11/2022,Bank Draft,1528,,Rothenberger Propane Gas Cylinder For Jet Torch Quick Super Micro Fire Brazing (253413391154,Business Card,73.86,"11,739.00"
,30/11/2022,Bank Draft,1459,,Monument MON262 262S Tub White Tallow Medium (232555002963,Business Card,10.73,"11,749.73"
,30/11/2022,Bank Draft,1501,,Everbuild RAW LINSEED OIL Wood Treatment Lubricant For French Polishing - 500ml (112136467304,Business Card,18.84,"11,768.57"
,30/11/2022,Bank Draft,1472,,"50 ml VASELINE OIL Reduces friction, preserves the components and protects UK (393133801819) Royal Mail",Business Card,44.9,"11,813.47"
,30/11/2022,Bank Draft,1531,,LOCTITE Super Glue 10g Bottle Precision Max Extra Long Nozzle Fast & Strong (191177572643),Business Card,43.8,"11,857.27"
,30/11/2022,Bank Draft,1488,,"8"" - 200mm Dreadnought Curved Tooth Tanged File (324050221113)",Business Card,8.99,"11,866.26"
,30/11/2022,Bank Draft,1458,,M4 M5 M6 M8 M10 SOCKET CUP POINT GRUB SCREWS HEX ALLEN SET SCREWS 14.9 BLACK (284006053630),Business Card,9.34,"11,875.60"
,30/11/2022,Bank Draft,1527,,"112""(2845mm) x 1/2"" Carbon Flex 8R (TPI) Starrett Duratec SFB bandsaw blade* (173883376573",Business Card,42.35,"11,917.95"
,30/11/2022,Bank Draft,1493,,Bright Mild Steel Flat Bar 20mmx8mm 400mm Long EN3B (373444867657,Business Card,9.5,"11,927.45"
,30/11/2022,Bank Draft,1454,,6mm END MILL WNT 50968062 Solid Carbide Silver Coated 4fl 1mm Rad (284131390663),Business Card,47.64,"11,975.09"
,30/11/2022,Bank Draft,1481,,"Tolsen Straight Jaw Locking Pliers 10"" (250mm) - Heavy Duty Mole Grip Vice Plier (293504949312)",Business Card,10.95,"11,986.04"
,30/11/2022,Bank Draft,1471,,"1L LITER VASELINE OIL Reduces friction, preserves the components and protects (124676791172)",Business Card,43.96,"12,030.00"
,30/11/2022,Bank Draft,1440,,Ball and spring plunger stainless steel M3 4 5 6 8 10 12 16 20 ball plungers jig (283450542764) Royal Mail,Business Card,28.5,"12,058.50"
,30/11/2022,Bank Draft,1521,,"Starcke Matador Waterproof Wet &
Dry Sandpaper",Business Card,190.4,"12,248.90"
,30/11/2022,Bank Draft,1468,,workswhop tools,Business Card,15.6,"12,264.50"
,30/11/2022,Bank Draft,1518,,workshop consumable,Business Card,30.4,"12,294.90"
,30/11/2022,Bank Draft,1434,,10x Mini Diamond Cutting Discs Wheel Blades Drill Bit Disc Dremel Rotary Tool (363470355049),Business Card,4.47,"12,299.37"
,30/11/2022,Bank Draft,1474,,Mitutoyo 500-196-30 Absolute AOS Digimatic Digital Electronic Vernier Caliper (254187257096) Royal Mail 2nd Class £178.00,Business Card,178,"12,477.37"
,30/11/2022,Bank Draft,1522,,workshop consumable,Business Card,31.98,"12,509.35"
,30/11/2022,Bank Draft,1456,,Bright Mild Steel Flat Bar Various Sizes 20mm x 3mm to 50mm x12mm (391170005087,Business Card,7.53,"12,516.88"
,30/11/2022,Ledger Entry,3359,,workshop material refund,-Split-,-32.57,"12,484.31"
,31/12/2022,Bank Draft,1587,,Sponge Paint Varnish,Business Card,4.16,"12,488.47"
,31/12/2022,Bank Draft,1583,,Torus High Performance Roughing End Mill,Business Card,23.45,"12,511.92"
,31/12/2022,Bank Draft,1644,,PURE TIN STANNUM,Business Card,25,"12,536.92"
,31/12/2022,Bank Draft,1621,,Natural Earth Pigments,Business Card,13.6,"12,550.52"
,31/12/2022,Bank Draft,1598,,3mm X 15mm Compression Springs 10pk Model Engineering,Business Card,2.46,"12,552.98"
,31/12/2022,Bank Draft,1559,,Wera Tools 12Pce Precision Screwdriver Tool Kit Star Torx Phillips Mixed In Case,Business Card,38.95,"12,591.93"
,31/12/2022,Bank Draft,1541,,Thor 1212 deadblow 38mm 1.1/2in 700g nylon face thorace hammer THO1212 (185136543657),Business Card,20.99,"12,612.92"
,31/12/2022,Bank Draft,1632,,Gas Burner Cooker,Business Card,59.98,"12,672.90"
,31/12/2022,Bank Draft,1600,,MILD STEEL SEAMLESS ROUND TUBE PIPE CDS 7.94mm,Business Card,11.5,"12,684.40"
,31/12/2022,Bank Draft,1627,,Stuarts Micrometer Engineers Marking,Business Card,4.4,"12,688.80"
,31/12/2022,Bank Draft,1588,,Brushes Set Sponge Paint Varnish Oils Art Craft,Business Card,4.92,"12,693.72"
,31/12/2022,Bank Draft,1582,,"Woven Wire, 200 Mesh, 77?m hole, 0.05mm wire, 316 Stainless Steel",Business Card,9.99,"12,703.71"
,31/12/2022,Bank Draft,1543,,Vintage Engineers Hand Vice Clamp (284476272063,Business Card,12,"12,715.71"
,31/12/2022,Bank Draft,1585,,16mm END MILL WIDIA HANITA ITC CARBIDE,Business Card,114.24,"12,829.95"
,31/12/2022,Bank Draft,1547,,"Superb Vintage handheld vice, clamp, hand vice. Military Stamped 1953",Business Card,19.75,"12,849.70"
,31/12/2022,Bank Draft,1614,,Zoro Uk,Business Card,20.36,"12,870.06"
,31/12/2022,Bank Draft,1622,,OPT-302-646,Business Card,15.99,"12,886.05"
,31/12/2022,Bank Draft,1616,,Magnetic Screwdriver Bit Holder Finger Saver,Business Card,14.85,"12,900.90"
,31/12/2022,Bank Draft,1544,,"Vintage hand held pin vice 1"" jaw (265096006954",Business Card,15,"12,915.90"
,31/12/2022,Bank Draft,1562,,Walter Prototyp HSS-E Machine Taps M20513-M3,Business Card,114,"13,029.90"
,31/12/2022,Bank Draft,1563,Tray Kevin,Sawn Treated Timber Regularised 47mm x 50mm x 3.0m,Business Card,121.68,"13,151.58"
,31/12/2022,Bank Draft,1599,,Compression Spring Various Size,Business Card,2.48,"13,154.06"
,31/12/2022,Bank Draft,1569,,ACRAGLAS - GEL 4oz KIT,Business Card,60.8,"13,214.86"
,31/12/2022,Bank Draft,1586,,boracic acid,Business Card,4.16,"13,219.02"
,31/12/2022,Bank Draft,1623,,Stainless Steel Repair Washers,Business Card,21.55,"13,240.57"
,31/12/2022,Bank Draft,1558,,1Lx2 Mannol Compressor Oil ISO 46 DIN 51506 Piston Air Compressor Oil (303857456726,Business Card,10.49,"13,251.06"
Total for Materials & Tools,,,,,,,"£13,251.06  ",
